ΑΝΤΙΓΟΝΙΣ	person
Αἰακίδαι	person
Αἰγίμιον	person
Αἰγίνης	place
Αἰγίνῃ	place
Αἰγεύς	person
Αἰγεῖ	person
Αἰγιμίου	person
Αἰγινήτας	person, place
Αἰγινητῶν	person, place
Αἰγυπτία	ethnic, person
Αἰγυπτίαν	ethnic, person
Αἰγυπτίας	ethnic, person
Αἰγυπτίοις	ethnic, person
Αἰγυπτίου	ethnic, person
Αἰγυπτίους	ethnic, person
Αἰγυπτίων	ethnic, person
Αἰγυπτίῳ	ethnic, person
Αἰγυπτιακὴ	place
Αἰγύπτιαι	ethnic, person
Αἰγύπτιοί	ethnic, person
Αἰγύπτιον	ethnic, person
Αἰγύπτιος	ethnic, person
Αἰγύπτου	person, place
Αἰγύπτῳ	person, place
Αἰθίοπας	ethnic, person
Αἰθίοπες	ethnic, person
Αἰθίοψ	ethnic, person
Αἰθίοψιν	ethnic, person
Αἰθιόπων	ethnic, person
Αἰλίου	person
Αἰμιλίου	person
Αἰμιλιανέ	person
Αἰμιλιανοῦ	person
Αἰμιλιανὸς	person
Αἰνείαν	person
Αἰνιᾶνες	place
Αἰξωνεὺς	person
Αἰολίδα	person
Αἰολίδος	person
Αἰολεῖς	person
Αἰολεῦσιν	person
Αἰολὶς	person
Αἰσχίνην	person
Αἰσχίνης	person
Αἰσχίνου	person
Αἰσχρίων	person
Αἰσχυλίδης	person
Αἰσχύλε	person
Αἰσχύλον	person
Αἰσχύλος	person
Αἰσχύλου	person
Αἰσχύλῳ	person
Αἰσώπῳ	person
Αἰτωλικὸν	person
Αἰτωλοῦ	person
Αἰτωλός	person
Αἱμονίᾳ	place
Αἴαντα	person, place
Αἴαντι	person, place
Αἴαντος	person, place
Αἴας	person, place
Αἴγιλα	place
Αἴγιναν	place
Αἴγισθος	person
Αἴγλην	person
Αἴγυπτον	person, place
Αἴγυπτος	person, place
Αἴλιος	person
Αἴξ	person
Αἴσονος	person
Αἴσωπός	person
Αἶαν	person, place
Αἶγα	person, place
Αἶνος	person, place
Αὐγέαν	person
Αὐδάταν	person
Αὐτοκλέης	person
Αὐτοκλῆς	person
Αὐτοκράτης	person
Αὐτολύκου	person
Αὐτολύκῳ	person
Αὐτόλυκον	person
Αὐτόλυκος	person
Αὔγης	person
Αὔγῃ	person
Βάβυν	person
Βάβυς	person
Βάθυλλος	person, place
Βάθυλλόν	person
Βάκις	person
Βάκχαι	person
Βάκχε	person
Βάκχον	person
Βάκχου	person
Βάκχῳ	person
Βάσιλις	person, place
Βάτων	person
Βάτωνι	person
Βίτων	person
Βίωνος	person
Βαίου	person
Βαίτων	person
Βαβυλωνίᾳ	ethnic, place
Βαβυλών	person, place
Βαγώου	person
Βαθυκλέους	person
Βαθυκλῆς	person
Βακχία	place
Βακχίδα	person
Βακχίδας	person
Βακχίδος	person
Βακχεῖος	person
Βακχιάδας	person
Βακχυλίδης	person
Βακχυλίδῃ	person
Βακχὶς	person
Βαλλίων	person
Βελλεροφόντην	person
Βελλεροφόντης	person
Βερενίκη	person, place
Βιλιστίχη	person
Βισάλται	person, place
Βισάλτας	person
Βλαῖσος	person
Βλεπαῖος	person
Βλεψίας	person
Βοιωτίαν	person
Βοιωτίας	person
Βοιωτίους	person
Βοιωτίων	person
Βοιωτίᾳ	person
Βοιωτίῳ	person
Βοιωτιακῷ	person
Βοιωτοὶ	person
Βοιωτοὺς	person
Βοιωτοῖς	person
Βοιωτοῦ	person
Βοιωτὸν	person
Βοιωτῶν	person
Βοιώ	ethnic, person
Βοιώτιαι	person
Βοιώτιοι	person
Βοιώτιον	person
Βοιώτιος	person
Βορέης	person
Βορέου	person
Βορέᾳ	person
Βορρᾶς	person
Βορυσθένους	person, place
Βορυσθενίτης	person
Βοσπόρου	person, place
Βοσπόρῳ	person, place
Βουκολίωνι	person
Βουρίχου	person
Βουσίριδι	person
Βρέννου	person
Βραυρῶνος	person
Βριάρεως	person
Βρισηίδα	person
Βρομίοιο	person
Βρομίου	person
Βρομίῳ	person
Βρόμιον	person
Βρόμιος	person
Βρύσων	person
Βρύσωνος	person
Βυζάντια	ethnic, person
Βυζάντιον	ethnic, place
Βυζαντίων	ethnic, place
Βόκχοριν	person
Βόλβῃ	place
Βόσπορος	person, place
Βῖθυν	person
Βῶρμον	person
ΓΕΛΩΝΙ	person
ΓΛΑΥΚΟΣ	person, place
Γάιος	person
Γάμβρειον	place
Γέλαν	place
Γέλας	place
Γέλωνα	person
Γέλωνος	person
Γέλᾳ	place
Γένθιον	person
Γέργιθα	place
Γέται	ethnic, place
Γαδείροις	place
Γαδείρων	place
Γαλάτας	ethnic, person
Γαλάτειαν	person
Γαλάτην	person
Γαλάτης	person
Γαλήνας	person
Γαλατίας	person, place
Γαλατείας	person
Γαλατείᾳ	person
Γαληνός	person
Γανυμήδει	person
Γανυμήδη	person
Γανυμήδην	person
Γανυμήδους	person
Γαργήττιος	person
Γεράνα	person, place
Γεργίθιον	person
Γεργιθίῳ	person
Γηρυτάδῃ	person
Γηρυόνου	person
Γηρυόνῃ	person
Γλαυκία	person
Γλαυκίδης	person
Γλαυκών	person
Γλαύκης	person
Γλαύκιππον	person
Γλαύκων	person
Γλαύκωνα	person
Γλαύκῳ	person
Γλοῦ	person
Γλυκέρα	person
Γλυκέραν	person
Γλυκέρας	person
Γλυκέριον	person
Γλύκη	person
Γνάθαινα	person
Γνάθαιναν	person
Γνήσιππος	person
Γναθαίνης	person
Γναθαίνιον	person
Γναθαίνῃ	person
Γναθαινίου	person
Γναθαινίῳ	person
Γνησίππου	person
Γνώμη	person
Γοργίαν	person
Γοργίας	person
Γοργίου	person
Γοργίᾳ	person
Γοργοῖ	person
Γοργοῦς	person
Γοργόνας	person
Γοργόνων	person
Γρυλλίων	person
Γρυμέα	person
Γρυνείου	person
Γόργος	person, place
Γόργων	person
Γύγης	person, place
Γύγου	person
Γύλιππον	person
Δάματερ	person
Δάματρα	person
Δάμιππον	person
Δάμων	person
Δάμωνα	person
Δάφνιδι	person
Δάφνος	person, place
Δήλιοι	ethnic, person
Δήλιον	ethnic, person
Δήλιος	ethnic, person
Δήμητρα	person
Δήμητρι	person
Δήμητρος	person
Δήμωνος	person
Δί	person
Δία	person
Δίας	person, place
Δίδυμος	person
Δίκης	person
Δίνων	person
Δίομος	person
Δίυλλος	person
Δίφιλε	person
Δίφιλον	person
Δίφιλος	person
Δίων	person, place
Δίωνα	person
Δίωνος	person
Δαίδαλε	person
Δαίδαλος	person
Δαίμαχος	person
Δαιδάλου	person
Δαιδάλῳ	person
Δαισίου	person
Δαμίππῳ	person
Δαμασκηνός	ethnic, person
Δαμοξένῳ	person
Δαμόξενος	person
Δανάη	person, place
Δανάην	person
Δανάης	person
Δαρδανίαν	person
Δαρδανεῖς	ethnic, place
Δαρείου	person
Δαρείῳ	person
Δαρεῖον	person
Δαρεῖος	person
Δασκύλου	person
Δεινιάδα	person
Δεινιάδου	person
Δεινιάς	person
Δεινομάχη	person
Δεινομάχης	person
Δεινόλοχος	person
Δελφικοὶ	person
Δελφικὸν	person
Δελφικῷ	person
Δελφοί	place
Δελφοὺς	place
Δελφοῖς	place
Δελφὸν	ethnic, person
Δελφὸς	ethnic, person
Δελφῶν	place
Δεξιθέας	person
Δεξιθέᾳ	person
Δεξικράτης	person
Δερκύλος	person
Δευκαλίων	person, place
Δευκαλίωνι	person
Δευκαλίωνος	person
Δηλίου	ethnic, person
Δηλίους	ethnic, person
Δηλίων	ethnic, person
Δηλίᾳ	ethnic, person
Δηλίῳ	ethnic, person
Δηλιάδες	person
Δηλιάδος	person
Δηλιάσι	person
Δημάδην	person
Δημάδης	person
Δημάδου	person
Δημέαν	person
Δημέου	person
Δημέᾳ	person
Δημήτηρ	person
Δημήτριον	person, place
Δημήτριος	person
Δημαράτῳ	person
Δημαρέτην	person
Δημητρίου	person, place
Δημητρίων	person, place
Δημητρίῳ	person
Δημοδάμας	person
Δημοδόκου	person
Δημοδόκῳ	person
Δημοκήδη	person
Δημοκήδης	person
Δημοκλέα	person
Δημοκλείδης	person
Δημοκλῆς	person
Δημοκράτης	person
Δημοκρίτου	person
Δημοκρίτῳ	person
Δημοσθένει	person
Δημοσθένη	person
Δημοσθένην	person
Δημοσθένης	person
Δημοσθένους	person
Δημοστράτου	person
Δημοτέλης	person
Δημοτίων	person
Δημοφῶν	person
Δημοφῶντα	person
Δημοφῶντος	person
Δημοχάρης	person
Δημοχάρους	person
Δημοῦς	person
Δημόδοκος	person
Δημόκριτε	person
Δημόκριτον	person
Δημόκριτος	person
Δημόνικος	person
Δημόφιλος	person
Δημύλε	person
Δημύλος	person
Δημώ	person
Δηοῦς	person
Δηὼ	person
Διαγόρα	person
Διαγόραν	person
Διαγόρας	person
Διδυμαίου	person
Διευχίδας	person
Διιτρέφης	person
Δικαίαρχον	person
Δικαίαρχος	person
Δικαιαρχείας	person
Δικαιοκλῆς	person
Διογένει	person
Διογένη	person
Διογένης	person
Διογένους	person
Διογείτων	person
Διοδώρου	person, place
Διοκλέα	person
Διοκλέους	person
Διοκλείδης	person
Διοκλεῖ	person
Διοκλῆς	person
Διομήδεα	person
Διομήδης	person
Διομήδους	person
Διομνήστου	person
Διονυσίου	person
Διονυσίῳ	person
Διονυσιάδα	festival, person, place
Διονυσιάδι	festival, person, place
Διονυσιάς	festival, person, place
Διονυσιακοῦ	person
Διονυσιακὰ	person
Διονυσιακὴ	person
Διονυσιακὴν	person
Διονυσιακῆς	person
Διονυσοκλέους	person
Διονυσοκλῆς	person
Διονυσόδωρον	person
Διονυσόδωρος	person
Διονύσια	festival, person, place
Διονύσιε	person
Διονύσιον	person
Διονύσιος	person
Διονύσου	person, place
Διονύσῳ	person, place
Διοπείθης	person
Διοπείθους	person
Διοσκουρίδης	person, place
Διοσκόρω	person
Διοτίμα	person
Διφίλου	person
Διφίλῳ	person
Διωνύσοιο	person, place
Διωνύσου	person, place
Διωνύσῳ	person, place
Διόγενες	person
Διόγνητος	person
Διόδοτος	person
Διόδωρον	person
Διόδωρος	person
Διόμνηστος	person
Διόνυσε	person, place
Διόνυσον	person, place
Διόνυσος	person, place
Διότιμος	person
Διόφαντος	person
Διώνης	person
Διώνυσος	person, place
Διώξιππον	person
Διώξιππος	person
Διὶ	person
Διὸς	person
Δορκία	person
Δορύλαιον	place
Δοῦριν	person
Δοῦρις	person
Δράκοντος	person
Δράκων	person, place
Δρίμακος	person
Δρομέας	person
Δρούσῳ	person
Δρωπίδῃ	person
Δρόμων	person
Δωδώνῃ	place
Δωρίδος	person, place
Δωρίου	person, place
Δωρίς	person
Δωρίχα	person
Δωρίων	person, place
Δωριάς	person, place
Δωριέα	person
Δωριέων	person, place
Δωρικός	person
Δωρικῶς	person
Δωροθέῳ	person
Δωρόθεός	person
Δωρὶς	person, place
Δωσιάδας	person
Δωτίδος	person
Δόλωνά	person
Δόλωνι	person
Δόρκων	person
Δώριον	person, place
Δώριος	person, place
Δώτιον	person, place
Δῆμος	person
Δῖνος	person
Δῶρι	person
Δῶρος	person
Εύκλείδης	person
Εἰλειθυίᾳ	person
Εὐάγγελος	person
Εὐάθλου	person
Εὐάλκης	person
Εὐάνθης	person
Εὐέργου	person
Εὐήγορος	person
Εὐήμερος	person
Εὐήνορος	person
Εὐήνωρ	person
Εὐαίων	ethnic, person
Εὐαγόραν	person
Εὐβοέες	person
Εὐβοέων	person
Εὐβοίας	person, place
Εὐβοίης	person, place
Εὐβοίᾳ	person, place
Εὐβοίῳ	person
Εὐβοεῖς	person
Εὐβοικοῦ	person
Εὐβοικὰ	person
Εὐβοικὸν	person
Εὐβουλίδης	person
Εὐβούλου	person
Εὐβούλῳ	person
Εὐδικός	person
Εὐδόξου	person
Εὐεργέτης	person
Εὐεργέτου	person
Εὐεργέτῃ	person
Εὐθίας	person
Εὐθίου	person
Εὐθυδήμου	person
Εὐθυδήμῳ	person
Εὐθυκλῆς	person
Εὐθύδημον	person
Εὐθύδημος	person
Εὐθύνου	person
Εὐθύφρων	person
Εὐκλείδην	person
Εὐκλείδης	person
Εὐκλείδου	person
Εὐκράτη	person
Εὐκράτην	person
Εὐκράτης	person
Εὐμένη	person
Εὐμένης	person
Εὐμένους	person
Εὐμήδης	person
Εὐνίκου	person
Εὐξένου	person
Εὐξένῳ	person
Εὐξίθεος	person
Εὐπαλάμου	person
Εὐπόλιδι	person
Εὐπόλιδος	person
Εὐριπίδην	person
Εὐριπίδης	person
Εὐριπίδου	person
Εὐριπίδῃ	person
Εὐρυδίκην	person
Εὐρυδίκης	person
Εὐρυκλῆς	person
Εὐρυμέδοντος	person
Εὐρυπτόλεμος	person
Εὐρυπύλου	person
Εὐρυσθέα	person
Εὐρυσθέως	person
Εὐρυσθεῖ	person
Εὐρυτίωνα	person
Εὐρύαλε	person
Εὐρύβατε	person
Εὐρύβιος	person
Εὐρύκλεια	person
Εὐρύμαχον	person
Εὐρύμαχος	person
Εὐρύπυλον	person
Εὐρύπυλος	person
Εὐρύτου	person
Εὐτέρπης	person
Εὐφήμου	person
Εὐφορίων	person
Εὐφορίωνά	person
Εὐφράνορά	person
Εὐφράνωρ	person
Εὐφραῖος	person
Εὐφρόνιος	person
Εὒαθλος	person
Εὒδωρος	person
Εὒηνος	person
Εὒθηρος	person
Εὔβοιαν	person, place
Εὔβοιον	person
Εὔβοιός	person
Εὔβουλον	person
Εὔβουλος	person
Εὔδημος	person
Εὔδικος	person
Εὔδοξος	person
Εὔηνον	person
Εὔθυνος	person
Εὔιον	person
Εὔιος	person
Εὔκλεια	person
Εὔμαιος	person
Εὔμαχος	person
Εὔμηλος	person
Εὔμολπος	person
Εὔνικος	person
Εὔνομον	person
Εὔνοστος	person
Εὔνους	person
Εὔξενον	person
Εὔξενος	person
Εὔπολίς	person
Εὔρυτον	person
Εὔφαντος	person
Εὔφημος	person
Εὔφορβον	person
Εὔφρονος	person
Εὔφρων	person
Ζάλευκον	person
Ζήθου	person
Ζήνων	person
Ζήνωνα	person
Ζήνωνι	person
Ζήνωνος	person
Ζακύνθιος	ethnic, person
Ζαλεύκου	person
Ζανὸς	person
Ζαριάδρην	person
Ζαριάδρης	person
Ζαριάδρου	person
Ζελείτης	person
Ζεφυρίτιδος	person
Ζεὺς	person
Ζεῦ	person
Ζηλᾶ	place
Ζηνοφάνης	person
Ζηνόδοτος	person
Ζηνὶ	person
Ζωίλος	person
Ζωπυρῖνος	person
Ζωπύρα	person
Ζώπυρος	person
Ζῆθον	person
Ζῆνις	person
Ζῆνος	person
ΘΗΡΙΚΛΕΙΟΣ	person
Θάλαττα	person
Θάμυριν	person
Θάσια	ethnic, person
Θάσιοι	ethnic, person
Θάσιον	ethnic, person
Θάσιος	ethnic, person
Θάσος	person, place
Θέογνίν	person
Θέογνις	person
Θέρσιππον	person
Θέσπις	person
Θέτιδος	person
Θέτις	person
Θέων	person
Θέωνα	person
Θήβαις	place
Θήβας	person, place
Θήβη	person, place
Θήβης	person, place
Θίβρων	person
Θίβρωνα	person
Θίμβρωνος	person
Θαίδα	person
Θαίδι	person
Θαλλόν	person
Θαλῆς	person
Θαμνεύς	person
Θαμύρᾳ	person
Θαργήλια	festival, person
Θασίαν	ethnic, person
Θασίας	ethnic, person
Θασίοις	ethnic, person
Θασίου	ethnic, person
Θασίους	ethnic, person
Θασίων	ethnic, person
Θαυμάριον	person
Θαυμασίων	person
Θαὶς	person
Θεάγης	person
Θεαίτητος	person
Θεαγένης	person
Θεαιτήτῳ	person
Θεανοῖ	person
Θεανοῦς	person
Θεανὼ	person
Θεαρίων	person
Θεμίσων	person
Θεμίσωνι	person
Θεμισταγόρας	person
Θεμιστοκλέα	person
Θεμιστοκλέους	person
Θεμιστοκλῆς	person
Θεμιστοῦς	person
Θεογνήτου	person
Θεοδέκτην	person
Θεοδέκτης	person
Θεοδέκτου	person
Θεοδέκτῃ	person
Θεοδωρίδα	person
Θεοδωρίδαν	person
Θεοδωρίδας	person
Θεοδότας	person
Θεοδότη	person
Θεοδότην	person
Θεοδότης	person
Θεοδότῃ	person
Θεοδώρου	person
Θεοδώρῳ	person
Θεοζστίδης	person
Θεοκλῆς	person
Θεοκρίτου	person
Θεολύτη	person
Θεοξένου	person
Θεοπόμπου	person
Θεοπόμπῳ	person
Θεοφίλου	person
Θεοφράστου	person
Θεοφράστῳ	person
Θερσίτου	person
Θεσσαλικὸς	ethnic, person
Θεσσαλούς	person
Θεσσαλοὶ	person
Θεσσαλοῖς	person
Θεσσαλοῦ	person
Θεσσαλὸν	person
Θεσσαλὸς	person
Θεσσαλῶν	person
Θεσσαλῷ	person
Θεστίου	person
Θετταλοί	person
Θετταλονίκην	person
Θετταλοὺς	person
Θετταλοῦ	person
Θετταλός	person
Θετταλὲ	person
Θετταλὴν	person
Θετταλὸν	person
Θετταλῶν	person
Θεωρίς	person
Θεόγνητος	person
Θεόγνιδος	person
Θεόδοτον	person
Θεόδοτος	person
Θεόδωρε	person
Θεόδωρον	person
Θεόδωρος	person
Θεόκλεια	person
Θεόκριτον	person
Θεόκριτος	person
Θεόλυτος	person
Θεόπομπον	person
Θεόπομπος	person
Θεόφιλος	person
Θεόφραστον	person
Θεόφραστος	person
Θηβαίαν	ethnic, person
Θηβαίδα	place
Θηβαίδι	place
Θηβαίδος	place
Θηβαίοις	ethnic, person
Θηβαίου	ethnic, person
Θηβαίους	ethnic, person
Θηβαίων	ethnic, person
Θηβαῖοι	ethnic, person
Θηβαῖον	ethnic, person
Θηβαῖος	ethnic, person
Θηβῶν	place
Θηραμένην	person
Θηραμένης	person
Θηρικλέους	person
Θηρικλῆς	person
Θησέα	person
Θησέως	person
Θησεὺς	person
Θησεῖ	person
Θουκυδίδην	person
Θουκυδίδης	person
Θουκυδίδου	person
Θουρίαν	person
Θούδιππος	person
Θούριος	person
Θράσυλλον	person
Θράσυλλος	person
Θράσωνί	person
Θράσωνα	person
Θρασυδαῖον	person
Θρασυλέων	person
Θρασυμάχου	person
Θρασυμήδης	person
Θρασύλλου	person
Θρασύλλῳ	person
Θρασύμαχον	person
Θρασύμαχος	person
Θυέστῃ	person
Θυμοίτης	person
Θύρσου	person
ΙΣΘΜΙΟΝ	person
ΚΕΡΑΣ	person, place
ΚΙΛΙΚΙΟΥΣ	ethnic, person
ΚΡΕΩΝ	person
Κάδμοιο	person, place
Κάδμον	person, place
Κάδμος	person, place
Κάδμου	person, place
Κάλλαισχρος	person
Κάλλιππος	person
Κάρανος	person
Κάρνεια	person
Κάρυστος	place
Κάσανδρον	person
Κάσανδρος	person
Κάστορος	person
Κάτων	person
Κέβητι	person
Κέκροπος	person
Κέκροψ	person
Κένταυροι	person
Κένταυρον	person
Κένταυρος	person
Κέρκυρα	place
Κέρκωψ	person
Κέφαλος	person
Κέω	place
Κήυκος	person
Κίλικα	ethnic, person
Κίλικες	ethnic, person
Κίλιξ	ethnic, person
Κίμων	person
Κίμωνι	person
Κίμωνος	person
Κίνδων	person
Κίρκῃ	person
Κίρρα	place
Κίων	person, place
Καίσαρος	person
Καικίλιος	person
Καινέα	person
Καινεῖ	person
Καλάνου	person
Καλίας	person
Καλλίαν	person
Καλλίας	person, place
Καλλίμαχον	person
Καλλίμαχος	person
Καλλίξεινος	person
Καλλίξενος	person
Καλλίου	person
Καλλίπυγον	person
Καλλίστιον	person
Καλλίστρατον	person
Καλλίστρατος	person
Καλλίστρατός	person
Καλλίᾳ	person, place
Καλλαίσχρου	person
Καλλαίσχρῳ	person
Καλλιάδης	person
Καλλιάδου	person
Καλλιάναξ	person
Καλλικλῆς	person
Καλλικράτην	person
Καλλικράτης	person
Καλλικράτους	person
Καλλιμάχου	person
Καλλιμέδων	person
Καλλιππίδης	person
Καλλιππίδῃ	person
Καλλιπύγου	person
Καλλισθένης	person
Καλλισθένους	person
Καλλιστοῖ	person
Καλλιστράτη	person
Καλλιστράτου	person
Καλλιστὼ	person
Καλλιφάνης	person
Καλλιόπην	person
Καλλῖνος	person
Καλυψοῖ	person
Καλυψοῦς	person
Καλχηδόνιος	ethnic, person
Καλχηδών	person, place
Καλύκη	person
Καλύκην	person
Καμβύσην	person
Καμβύσης	person, place
Καμβύσου	person
Κανθάρου	person
Κανώβῳ	person
Καπίτων	person
Καπανέως	person
Καπανεὺς	person
Καράνου	person
Καρίας	ethnic, person
Καρίνῃ	person
Καρίων	ethnic, person, place
Καρίᾳ	ethnic, place
Καρδιανὸς	person
Καρικοῖς	person
Καρικοῦ	person
Καρικὸν	person
Καρικῷ	person
Καρκίνου	person
Καρσὶ	person
Καρυάτιδες	place
Καρχηδονίοις	person
Καρχηδονίων	person
Καρχηδονίῳ	person
Καρχηδόνα	person
Καρχηδόνι	person
Καρχηδόνιοι	person
Καρχηδόνιος	person
Καρχηδόνος	person
Καρχηδὼν	person
Καρύστιος	ethnic, person, place
Καρὸς	person
Καρῶν	person
Κασάνδρῳ	person
Κασσάνδραν	person
Κασσάνδρου	person
Καταιβάτῃ	person
Καφισίας	person
Καύαρος	person
Καύκαλος	person
Καύκωνός	person
Καύνῳ	place
Καῖσαρ	person
Κείου	place
Κείων	place
Κεκροπίδαι	person
Κεκροπιδῶν	person
Κενταύροις	person
Κενταύρων	person
Κενταύρῳ	person
Κεραμεικοῦ	place
Κεραμεικὸς	place
Κεραμεικῷ	place
Κερκιδᾶν	person
Κερκιδᾶς	person
Κερκυραία	place
Κερκυραίας	place
Κερκυραίους	place
Κερκυραῖος	place
Κερκύονος	person
Κερκύρας	place
Κερκώπων	person
Κεφάλῳ	person
Κεφαλίωνα	person
Κεφαλίωνος	person
Κεῖός	place
Κηφισοδώρου	person
Κηφισόδοτον	person
Κηφισόδωρον	person
Κηφισόδωρος	person
Κηφισῷ	person, place
Κιλικίαν	ethnic, person
Κιλικίας	ethnic, person
Κιλικίᾳ	ethnic, person
Κινησία	person
Κινησίαν	person
Κινησίας	person
Κινησίου	person
Κινύρᾳ	person
Κισσὸς	place
Κιτιέα	person
Κιτιέως	person
Κιτιεύς	person
Κιτιεῖ	person
Κιτιᾶ	person
Κλέανδρον	person
Κλέαρχον	person
Κλέαρχός	person
Κλέων	person
Κλέωνος	person
Κλαυδίῳ	person
Κλεάνθει	person
Κλεάνθης	person
Κλεάνθους	person
Κλεάνορος	person
Κλεάρχου	person
Κλείδημος	person
Κλείσοφος	person
Κλείταρχος	person
Κλείτων	person
Κλείτῳ	person
Κλεαίνετος	person
Κλεινίαν	person
Κλεινίας	person
Κλεινίου	person
Κλειοῖ	person
Κλεισθένει	person
Κλεισθένους	person
Κλειτόμαχος	person
Κλειτόφων	person
Κλειὼ	person
Κλεοβουλίνη	person
Κλεοβούλου	person
Κλεομάχου	person
Κλεομένη	person
Κλεομένης	person
Κλεομένους	person
Κλεομβρότου	person
Κλεονίκη	person
Κλεονίκης	person
Κλεοπάτρα	person, place
Κλεοπάτραν	person
Κλεοπάτρας	person
Κλεοπτολέμου	person
Κλεοστράτου	person
Κλεοφάνη	person
Κλεοφῶντι	person
Κλεωνύμου	person
Κλεόβουλος	person
Κλεόμβροτος	person
Κλεόμβροτόν	person
Κλεόνικος	person
Κλεώνυμον	person
Κλεώνυμος	person
Κλεὼ	person
Κλεῖτος	person
Κλυταιμνήστρᾳ	person
Κλωθώ	person
Κλύτος	person
Κνωσσῷ	person
Κοίρανον	person
Κοθήλας	person
Κοικόα	person
Κολλυτεύς	person
Κολχίσι	person
Κολχὶς	person
Κοναλίς	person
Κορίνθιαι	ethnic, person
Κορίνθιοι	ethnic, person
Κορίνθιον	ethnic, person
Κορίνθιος	ethnic, person
Κορίνθου	person, place
Κορίνθῳ	person, place
Κορίννῃ	person
Κορίσκος	person
Κοριαννώ	person
Κορινθίαν	ethnic, person
Κορινθίας	ethnic, person
Κορινθίοις	ethnic, person
Κορινθίου	ethnic, person
Κορινθίους	ethnic, person
Κορινθίων	ethnic, person
Κορινθίᾳ	ethnic, person
Κορινθίῳ	ethnic, person
Κορκυραῖος	ethnic, person
Κορύδου	person
Κορύδῳ	person
Κορώνη	person, place
Κουρῆτες	place
Κούριος	person
ΚρΙτων	person
Κράσσον	person
Κράσσου	person
Κράτης	person
Κράτητα	person
Κράτητι	person
Κράτητος	person
Κρέοντος	person
Κρήτη	person, place
Κρήτην	person, place
Κρήτης	person, place
Κρίτων	person
Κρίτωνι	person
Κρίτωνος	person
Κραναόν	person
Κραναὸς	person, place
Κρανείῳ	person
Κρασσιανόν	person
Κρατίνου	person
Κρατίνῳ	person
Κρατίστολος	person
Κρατερῷ	person
Κρατύλος	person
Κρατύλῳ	person
Κρατῖνον	person
Κρατῖνος	person
Κρεώφυλος	person
Κρησί	person
Κρησὶν	person
Κρητί	person
Κρητικάς	person
Κρητικαί	person
Κρητικοῖς	person
Κρητικοῦ	person
Κρητικὰ	person
Κρητικῶν	person
Κρητικῷ	person
Κρητὸς	person
Κρητῶν	person, place
Κριτίαν	person
Κριτίας	person
Κριτόβουλον	person
Κριτόβουλος	person
Κροίσου	person
Κρονίδα	person
Κρονίων	person, place
Κρονίωνι	person, place
Κρωβύλῳ	person
Κρόνον	person
Κρόνος	person
Κρόνου	person
Κρόνῳ	person
Κρώβυλος	person
Κρὴς	person
Κρᾶθις	person, place
Κρῆτα	person, place
Κρῆτας	person, place
Κρῆτες	person
Κτήσιππος	person
Κτήσων	person
Κτησίαν	person
Κτησίας	person
Κτησίβιον	person
Κτησίβιος	person
Κτησίᾳ	person
Κτησιβίου	person
Κτησικλέους	person
Κτησικλῆς	person
Κτησιφῶν	person, place
Κτησιφῶντος	person
Κυβέλας	person
Κυδίαν	person
Κυδοιμὸς	person
Κυζίκου	person, place
Κυζίκῳ	person, place
Κυζικηνοὶ	person, place
Κυζικηνοῖς	person, place
Κυζικηνοῦ	person, place
Κυζικηνόν	person, place
Κυζικηνὸς	person, place
Κυζικηνῶν	person, place
Κυζικηνῷ	person, place
Κυθήριον	ethnic, person, place
Κυθήριος	ethnic, person, place
Κυθήροις	person, place
Κυθηρίας	ethnic, person, place
Κυθηρίου	ethnic, person, place
Κυμαῖος	ethnic, person, place
Κυνοσάργει	person
Κυνούλκου	person
Κυπρίας	ethnic, person
Κυπρίοις	ethnic, person
Κυπρίου	ethnic, person
Κυπρίους	ethnic, person
Κυπρίων	ethnic, person
Κυπρίῳ	ethnic, person
Κυπρογένεια	person
Κυρήνην	person, place
Κυρήνης	person, place
Κυρήνῃ	person, place
Κυρηναικὴ	person
Κυρηναῖος	ethnic, person
Κωκάλου	person
Κωκάλῳ	person
Κόδρος	person
Κόιντος	person
Κόλχων	person
Κόμμοδος	person
Κόμων	person
Κόννος	person
Κόννῳ	person
Κόνων	person
Κόνωνος	person
Κόρινθον	person, place
Κόρινθος	person, place
Κόρμος	person
Κόροιβος	person
Κόρυδον	person
Κόττας	person, place
Κότυν	person
Κότυος	person
Κότυς	person
Κύθηρα	person, place
Κύκνῳ	person
Κύνουλκε	person
Κύνουλκος	person
Κύπρι	person
Κύπρια	ethnic, person
Κύπριδι	person
Κύπριδος	person
Κύπριν	person
Κύπριοι	ethnic, person
Κύπριον	ethnic, person
Κύπριος	ethnic, person
Κύπρις	person
Κύπρον	person, place
Κύπρος	person, place
Κύπρου	person, place
Κύπρῳ	person, place
Κύρου	person
Κύρῳ	person
Κύψελον	person
Κᾶράς	person
Κᾶρες	person
Κῦρον	person, place
Κῦρος	person, place
Κῴας	ethnic, place
Κῴοις	ethnic, place
Κῶμε	place
Κῷοι	ethnic, place
Κῷον	ethnic, place
Κῷος	ethnic, place
ΛΑΚΑΙΝΑΙ	person
Λάβδακος	person
Λάγον	person
Λάιον	person
Λάιος	person
Λάκαινα	person
Λάκαιναν	person
Λάκιον	person
Λάκιος	person
Λάκων	ethnic, person
Λάκωνά	ethnic, person
Λάκωνας	ethnic, person
Λάκωνες	ethnic, person
Λάκωνι	ethnic, person
Λάκωνος	ethnic, person
Λάμαχος	person
Λάμια	person, place
Λάμιαν	person, place
Λάμπρος	person
Λάμπρῳ	person
Λάμπωνα	person
Λάμπωνι	person
Λάριχον	person
Λάριχος	person
Λάρκας	person
Λάσου	person
Λάσῳ	person
Λάχης	person
Λάχητι	person
Λάχητος	person
Λέαγρος	person
Λέαινα	person
Λέαιναν	person
Λέρνης	place
Λέσβιος	ethnic, person
Λέσβον	place
Λέσβου	place
Λέσβῳ	place
Λέων	person
Λήδαν	person
Λήδας	person
Λήδᾳ	person
Λήθῃ	person
Λήμνοιο	person, place
Λήμνῳ	person, place
Λίβυν	ethnic, person
Λίβυς	ethnic, person
Λίβυσι	ethnic, person
Λίβυσσαν	ethnic, person
Λίνος	person
Λίνῳ	person
Λίχαν	person
Λαέρτα	person
Λαέρτην	person
Λαέρτης	person, place
Λαέρτῃ	person
Λαίδα	person
Λαίδι	person
Λαίδος	person
Λαίς	person, place
Λαίῳ	person
Λαγίσκα	person
Λακίου	person
Λακαίνας	person
Λακαίνης	person
Λακεδαίμονα	place
Λακεδαίμονι	place
Λακεδαίμονος	place
Λακεδαίμων	place
Λακεδαιμόνιος	ethnic, person
Λακινίου	person
Λακωνικαί	ethnic, person
Λακωνικαῖς	ethnic, person
Λακωνικοὺς	ethnic, person
Λακωνικοῖς	ethnic, person
Λακωνικοῦ	ethnic, person
Λακωνικόν	ethnic, person
Λακωνικὰ	ethnic, person
Λακωνικὰς	ethnic, person
Λακωνικὴ	ethnic, person
Λακωνικὸς	ethnic, person
Λακωνικῆς	ethnic, person
Λακωνικῶν	ethnic, person
Λακωνικῶς	ethnic, person
Λακύδης	person
Λακώνων	ethnic, person
Λαμίας	person, place
Λαμίσκος	person
Λαμπάς	person, place
Λαμπιτοῦς	person
Λαμπιτὼ	person
Λαμπρίᾳ	person
Λαμπροκλῆς	person
Λαμυνθίου	person
Λαμύνθιος	person
Λανίκης	person
Λαοδάμας	person
Λαοδίκη	person
Λαοδίκης	person
Λαοδικεὺς	person
Λαπίθας	person
Λαρήνσιε	person
Λαρήνσιος	person
Λαρίσῃ	person, place
Λαρηνσίου	person
Λαρισαία	ethnic, person
Λαρισαίοις	ethnic, person
Λαρισαίους	ethnic, person
Λαρισαῖος	ethnic, person
Λασθενείας	person
Λασύρτας	person
Λατὼ	person
Λαχάρης	person
Λαχάρους	person
Λεαίνης	person
Λειψύδριον	place
Λεκτόν	person, place
Λεοννάτῳ	person
Λεοντίου	person
Λεοντίσκον	person
Λεοντίσκος	person
Λεοντεὺς	person
Λεοντῆος	person
Λεοντῖνος	ethnic, person
Λεπτίνας	person
Λεσβία	ethnic, person
Λεσβοθέμιδος	person
Λευκάδιος	ethnic, person
Λευκίου	person, place
Λευκαδίᾳ	person, place
Λευκτρικὰ	person
Λευκτρικὸν	person
Λευκτρικὸς	person
Λευκόλλου	person
Λεωγόρας	person
Λεωκράτει	person
Λεωκράτους	person
Λεωνίδη	person
Λεωνίδης	person
Λεωνίδου	person, place
Λεωτροφίδου	person
Λεωχάρης	person
Λεόντιον	person, place
Λεόντιος	person
Λεύκιος	person
Λεύκολλος	person
Λεύκων	person, place
Λεώφρων	person
Λεῦκε	person, place
Ληιστάδαι	place
Ληναίου	festival, place
Λητοΐδου	person
Λητοῖ	person
Λητοῦς	person
Λητώ	person
Λιβύης	place
Λιβύων	ethnic, person
Λικίννιον	person
Λικιννίου	person
Λικύμνιος	person
Λιμναῖον	ethnic, place
Λιμὸς	person
Λινδία	ethnic, place
Λιτυέρσας	person
Λιτυέρσης	person
Λιτυέρσᾳ	person
Λοκρίς	ethnic, person
Λοκροῖς	ethnic, person
Λοκρός	ethnic, person
Λοκρὸν	ethnic, person
Λοκρῶν	ethnic, person
Λοξίου	person
Λυαῖον	person
Λυγδάμιδος	person
Λυγκέα	person, place
Λυγκέως	person
Λυγκεὺς	person
Λυγκεῦ	person
Λυδίαν	person
Λυδίας	person
Λυδίοις	person
Λυδίου	person
Λυδίων	person
Λυδίᾳ	person
Λυδαί	ethnic, person
Λυδοὶ	ethnic, person
Λυδοὺς	ethnic, person
Λυδοῖς	ethnic, person
Λυδοῦ	ethnic, person
Λυδόν	ethnic, person
Λυδὰς	ethnic, person
Λυδὴ	ethnic, person
Λυδὸς	ethnic, person
Λυδῆς	ethnic, person
Λυδῶν	ethnic, person
Λυδῷ	ethnic, person
Λυκάονος	person
Λυκέας	person
Λυκίας	ethnic, person
Λυκίοις	ethnic, person
Λυκίου	ethnic, person
Λυκίους	ethnic, person
Λυκίσκῳ	person
Λυκίων	ethnic, person
Λυκίᾳ	ethnic, person
Λυκείῳ	person
Λυκούργῳ	person, place
Λυκοῦργον	person
Λυκοῦργος	person
Λυκόοργος	person
Λυκόφρονα	person
Λυκόφρονος	person
Λυκόφρων	person
Λυσάνδρου	person
Λυσίαν	person
Λυσίας	person, place
Λυσίθεος	person
Λυσίμαχον	person
Λυσίμαχος	person
Λυσίου	person
Λυσανίας	person
Λυσικλείδης	person
Λυσιμάχου	person
Λυσιμάχῳ	person
Λυσιμένης	person
Λυσιστράτῃ	person
Λύδιον	person
Λύκα	person, place
Λύκε	place
Λύκειον	person
Λύκιαι	ethnic, person
Λύκιος	ethnic, person
Λύκων	person
Λύκωνι	person
Λύκωνος	person
Λύσανδρον	person
Λύσανδρος	person
Λύσιππον	person
Λύσιππος	person
Λᾶσος	place
Λῆμνος	person, place
Λῦσις	person
ΜΗΤΡΑΣ	person
Μάγνης	person
Μάγνησιν	person
Μάγνητα	person
Μάγνητες	person
Μάγνητος	person
Μάγνος	person
Μάγνου	person
Μάγων	person
Μάκαρος	person, place
Μάλακος	person
Μάνη	person
Μάνιος	person, place
Μάρης	person
Μάριον	person, place
Μάρκελλος	person
Μάρκου	person
Μάρων	person
Μάρωνος	person
Μάτρων	person
Μάτρωνα	place
Μάτων	person
Μάχων	person
Μάχωνι	person
Μάχωνος	person
Μέγαλλος	person
Μέγιλλος	person
Μέδοντα	person
Μέδοντος	person
Μέδουσα	person
Μέλανθος	person, place
Μέλης	person, place
Μέλητος	person, place
Μέμνονα	person
Μέναιχμος	person
Μένανδρός	person
Μένιππος	person
Μέντορος	person
Μέντωρ	person
Μέντῃ	person
Μένωνί	person
Μένωνα	person
Μένωνος	person
Μήδειαν	person
Μήδους	ethnic, person
Μήδων	ethnic, person
Μήδῳ	ethnic, person
Μήλιος	ethnic, person
Μήνης	person
Μίδαν	person
Μίδας	person
Μίδης	person
Μίδου	person
Μίθαικον	person
Μίθαικος	person
Μίθρῃ	person
Μίκκος	person
Μίλητον	person, place
Μίλητός	person, place
Μίλων	person
Μίλωνα	person
Μίμνερμον	person
Μίμνερμος	person
Μίνω	person
Μίνωα	person
Μίνωος	person
Μίνως	person
Μαίσων	person
Μαγνήτων	person
Μαγνῆτις	person
Μαιάνδριος	person
Μαιάνδρου	person, place
Μαιάνδρῳ	person, place
Μαιανδρίην	person
Μαιανδρίου	person
Μακέται	place
Μακαρεὺς	person
Μακεδονίαν	ethnic, person
Μακεδονίας	ethnic, person
Μακεδονίᾳ	ethnic, person
Μακεδονικόν	ethnic, person
Μακεδονικὰς	ethnic, person
Μακεδονικὴ	ethnic, person
Μακεδονικῆς	ethnic, person
Μακεδονικῶν	ethnic, person
Μακεδόνα	ethnic, person
Μακεδόνας	ethnic, person
Μακεδόνες	ethnic, person
Μακεδόνος	ethnic, person
Μακεδόνων	ethnic, person
Μακεδόσιν	ethnic, person
Μακεδὼν	ethnic, person
Μαμερτῖνος	ethnic, person
Μανία	person, place
Μανδρογένης	person
Μαντιθέου	person
Μαντοῦς	person
Μαντὼ	person
Μαρίου	person
Μαραθῶν	person, place
Μαραθῶνι	person, place
Μαραθῶνος	person, place
Μαρδονίου	person
Μαρδονίῳ	person
Μαρδόνιον	person
Μαριανδυνοὶ	place
Μαριανδυνὸν	person
Μαρικᾷ	person
Μαρσύαν	person
Μαρσύας	person, place
Μαρσύᾳ	person
Μαρωνείᾳ	place
Μασσαλίαν	place
Μασσαλίᾳ	place
Μασσαλιήταις	place
Μασσαλιητῶν	place
Μασσαλιωτῶν	place
Μασσανάσσης	person
Μασσανάσσου	person
Ματρέας	person
Ματρέου	person
Μαχάονι	person
Μαχάονος	person
Μαχάτα	person
Μαχάων	person
Μεγαβύζου	person
Μεγακλέους	person
Μεγακλείδης	person
Μεγακλῆς	person
Μεγαλοστράτα	person
Μεγαλοστράτης	person
Μεγαπένθης	person
Μεγαπένθους	person
Μεγαρέα	person
Μεγαρέας	person
Μεγαρέων	person
Μεγαρεὺς	person
Μεγαρεῖς	person
Μεγαροῖ	person
Μεγαρὶς	place
Μεγαρῆας	person
Μεγαρῆς	person
Μεγασθένης	person
Μεγιστὼ	person
Μειδίαν	person
Μειδίου	person
Μειλίχιον	person
Μειλιχίου	person
Μελάμποδα	person
Μελάμπους	person
Μελάνθιος	person, place
Μελάνθιόν	person
Μελάνθῳ	person
Μελάνιππος	person
Μελέαγρος	person
Μελήτου	person
Μελίβοιαν	person
Μελίσσῃ	person
Μελαινὶς	person
Μελανίωνι	person
Μελανθίου	person
Μελανιππίδην	person
Μελανιππίδης	person
Μελανιππίδῃ	person
Μελανώπῳ	person
Μελεάγρου	person
Μελεάγρῳ	person
Μελησίαν	person
Μελησίας	person
Μελιβοίᾳ	person
Μελικέρτην	person
Μελικέρτου	person
Μελιταῖα	ethnic, place
Μενάλκου	person
Μενάνδρου	person
Μενάνδρῳ	person
Μενέδημον	person
Μενέδημος	person
Μενέλαε	person, place
Μενέλαον	person, place
Μενέλαος	person, place
Μενέλεων	person, place
Μενέλεως	person, place
Μενέλεῳ	person, place
Μενέξενος	person
Μενδήσιός	ethnic, place
Μενδαίου	person
Μενδαίῳ	person
Μενδαῖον	person
Μενεδήμου	person
Μενεκλέα	person
Μενεκλῆς	person
Μενεκράτει	person
Μενεκράτης	person
Μενεκράτους	person
Μενελάου	person, place
Μενελάῳ	person, place
Μενεξένῳ	person
Μενεσθένης	person
Μενών	person
Μεσσάπιοι	place
Μεσσήνιος	ethnic, person
Μετάνειρα	person
Μετάνειραν	person
Μεταγένην	person
Μεταγένης	person
Μηδία	place
Μηδείας	person
Μηδείᾳ	person, place
Μηλιεῖς	person
Μηνοδότου	person
Μηνοδότῳ	person
Μηνόδοτος	person
Μηνόδωρος	person
Μηριόνη	person
Μηριόνην	person
Μητροβίου	person
Μητρόδωρον	person, place
Μητρόδωρος	person
Μιδίας	person
Μιθριδάτην	person
Μιθριδάτης	person
Μιθριδάτου	person
Μιθριδατικὰ	person
Μικίωνος	person
Μιλήσια	ethnic, person
Μιλήσιοι	ethnic, person
Μιλήσιον	ethnic, person
Μιλήσιος	ethnic, person
Μιλήτου	person, place
Μιλήτῳ	person, place
Μιλησίας	ethnic, person
Μιλησίοις	ethnic, person
Μιλησίου	ethnic, person
Μιλησίους	ethnic, person
Μιλησίων	ethnic, person
Μιλτιάδης	person
Μιλτιάδου	person
Μιμνέρμου	person
Μισγόλαν	person
Μισγόλας	person
Μνάσων	person
Μνάσωνα	person
Μνασάλκης	person
Μνασέαν	person
Μνασέας	person
Μνασιγείτων	person
Μνημοσύνης	person
Μνημοσύνῃ	person
Μνησίθεος	person
Μνησίμαχος	person
Μνησαρέτην	person
Μνησιθέου	person
Μνησιμάχῳ	person
Μνησιπτολέμου	person
Μνησιπτόλεμον	person
Μνᾶσις	person
Μοίριχος	person
Μοίσαις	person
Μοιροκλῆς	person
Μολοσσίας	person
Μολοσσίδα	person
Μολοσσοὶ	person
Μολοσσόν	person
Μολοττοὺς	person
Μολοττῶν	person
Μονουνίου	person
Μορύχου	person
Μοσχίων	person
Μοσχίωνα	person
Μοσχίωνι	person
Μοσχίωνος	person
Μουνυχίᾳ	person
Μουσάων	person
Μουσέων	person
Μουσαῖος	person
Μουσείου	person
Μούκιος	person
Μούσαις	person
Μούσαισι	person
Μούσης	person
Μούσῃ	person
Μούσῃσι	person
Μοῦσα	person
Μοῦσαι	person
Μοῦσαν	person
Μυκερῖνον	person
Μυνδίῳ	person
Μυννίσκος	person
Μυοῦντα	person
Μυοῦντος	person
Μυρμηκίδης	person
Μυρμιδόνος	person
Μυρρίνην	person
Μυρσίλος	person
Μυρτίλε	person
Μυρτίλον	person
Μυρτίλος	person
Μυρτίλου	person
Μυρτίλῳ	person
Μυρτώ	person
Μυρωνίδης	person
Μυσίᾳ	person, place
Μυσοὶ	ethnic, place
Μυσταλίδης	person
Μυτιλήνῃ	person, place
Μόλπιδι	person
Μόλπις	person
Μόνιμος	person
Μόρυχος	person
Μόσχε	person
Μόψου	person
Μόψῳ	person
Μύκονον	place
Μύλασα	place
Μύνδιος	person
Μύρτιον	person, place
Μύρτις	person
Μύρωνος	person, place
Μύσιον	person, place
Μύστα	person
Μώσαις	person
Μᾶτρις	person
Μῆδοι	ethnic, person
Μῆδος	ethnic, person
Νάννιον	person
Νάνος	person
Νάξιον	person
Νάξου	person, place
Νάξῳ	person
Νάρις	person
Νέαιραν	person
Νέμεσιν	person
Νέστορα	person
Νέστορι	person
Νέστορος	person
Νέστωρ	person
Νίκανδρον	person
Νίκανδρος	person
Νίκιον	person
Νίκων	person, place
Νίκῃ	person
Ναιάδων	person
Ναννάριον	person
Ναξία	person, place
Ναξίαν	person, place
Ναξίας	person, place
Ναυκράτους	person
Ναυσικάαν	person
Ναυσικάᾳ	person
Ναυσικράτης	person
Ναυσικύδης	person
Ναύσιον	person
Ναὶς	place
Νεάνθην	person
Νεάνθης	person
Νείλου	person, place
Νεαίρας	person
Νεαίρᾳ	person
Νεμέᾳ	person, place
Νεοκλῆς	person
Νεοπτολέμῳ	person
Νεοπτόλεμος	person
Νεστορίδα	person
Νεῖλον	person, place
Νεῖλος	person, place
Νηλέα	person
Νηρέα	person
Νηρέως	person
Νηρεὺς	person
Νηρεῖ	person
Νηρῆος	person
Νικάνδρου	person
Νικάνδρῳ	person
Νικάνορος	person
Νικάνωρ	person
Νικήρατος	person
Νικίαν	person
Νικίας	person
Νικίου	person, place
Νικαίνετος	person
Νικαγόρας	person
Νικαρέτη	person
Νικηράτου	person
Νικησίας	person
Νικησίπολις	person
Νικοβούλη	person
Νικοδήμου	person
Νικοκλέα	person
Νικοκλέους	person
Νικοκλεῖ	person
Νικοκλῆς	person
Νικοκράτην	person
Νικοκρέοντι	person
Νικοκρέοντος	person
Νικοκρέων	person
Νικολάου	person
Νικομήδει	person
Νικομήδης	person
Νικομήδους	person
Νικομαχίδης	person
Νικομηδέων	place
Νικοστράτην	person
Νικοστράτου	person
Νικοστράτῳ	person
Νικοφάνη	person
Νικοφῶν	person
Νικοχάρης	person
Νικόδημον	person
Νικόλαος	person
Νικόμαχον	person
Νικόμαχος	person
Νικόστρατον	person
Νικόστρατος	person
Νιόβα	person
Νιόβης	person
Νιόβῃ	person
Νοήμων	person
Νουμήνιον	person, place
Νουμήνιος	person
Νυμφοδώρου	person
Νυμφόδωρος	person
Νυσαίου	person
Νυσαῖος	person
Νόστων	person
Νότῳ	person
Νύμφαις	place
Νύμφις	person
Νύξ	person
Νύσης	person, place
Νῦσαν	person, place
Ξάνθιππος	person
Ξάνθος	person, place
Ξέναρχος	person
Ξέρξεω	person
Ξέρξην	person
Ξέρξης	person
Ξέρξου	person
Ξανθία	person
Ξανθίαν	person
Ξανθίππη	person
Ξανθίππην	person
Ξανθίππης	person
Ξανθίππου	person
Ξενοκλείδου	person
Ξενοκλῆς	person
Ξενοκράτει	person
Ξενοκράτην	person
Ξενοκράτης	person
Ξενοκράτους	person
Ξενοφάνη	person
Ξενοφάνης	person
Ξενοφάνους	person
Ξενοφῶν	person
Ξενοφῶντα	person
Ξενοφῶντι	person
Ξενοφῶντος	person
Οἰάγροιο	person
Οἰδίποδι	person
Οἰδίπου	person
Οἰδίπουν	person
Οἰδίπους	person
Οἰδιπόδῃ	person
Οἰνάνθης	person
Οἰνέα	person
Οἰνέως	person
Οἰνεὺς	person
Οἰνεῖ	person
Οἰνομάῳ	person
Οἰνοπίων	person
Οἰνοπίωνι	person
Οἰνοπίωνος	person
Οἰνόη	place
Οἰνόμαος	person
Οἰνώναν	person
Οἰνώπας	person
Οἴα	person, place
Οὐάρρων	person
Οὐλπιανέ	person
Οὐλπιανοῦ	person
Οὐλπιανὸν	person
Οὐλπιανὸς	person
Οὐλπιανῷ	person
Οὐλύμποιο	place
Οὐλύμπου	place
Οὐρανίου	person
Οὐρανόν	person
Πάγγαιον	place
Πάμφιλον	person
Πάμφιλος	person
Πάν	person
Πάνδαρον	person
Πάξαμος	person
Πάραλος	person
Πάριδος	person
Πάριν	person, place
Πάριον	person, place
Πάριος	person, place
Πάρις	person, place
Πάτροκλον	person
Πάτροκλος	person
Πάφιος	place
Πάφῳ	place
Πέλοπι	person
Πέλοπος	person
Πέλωρος	person, place
Πέρσαι	ethnic, person
Πέρσαις	ethnic, person
Πέρσας	ethnic, person
Πέρσην	ethnic, person
Πέρσης	ethnic, person
Πέρσου	ethnic, person
Πήγασος	person
Πήδασον	person
Πίνδαρον	person
Πίνδαρος	person
Παίονάς	place
Παίοσιν	place
Παγασαὶ	place
Παγκράτης	person
Παγώνδου	person
Παιάνων	person
Παιωνίου	person
Παιόνων	place
Παιῶνα	person
Παλαίσκηψιν	person
Παλαίφατος	person
Παλαμήδην	person
Παλαμήδης	person
Παλλὰς	person, place
Παμφίλῃ	person
Παμφίλῳ	person
Πανί	person
Παναίτιος	person
Παναθηναικὰ	person
Πανδάρῳ	person
Πανδίονος	person
Πανδρόσου	person
Πανδρόσῳ	person
Πανιώνιον	place
Πανορμῖτις	person, place
Παντίκα	person
Πανταλέοντος	person
Πανταλέων	person
Πανύασις	person
Πανὸς	person
Παράλιος	person
Παρίου	person, place
Παρίῳ	person, place
Παρθένιος	person, place
Παρθενία	person, place
Παρθικὴν	person
Παρμένων	person
Παρμενίδην	person
Παρμενίδης	person
Παρμενίδου	person
Παρμενίδῃ	person
Παρμενίσκος	person
Παρμενίσκου	person
Παρμενίων	person
Παρράσιος	person
Παρρασίῳ	person
Πασίκυπρος	person
Πατρεύς	ethnic, person
Πατροκλέους	person
Πατροκλῆς	person
Πατρόκλου	person
Πατρόκλῳ	person
Παυσίαν	person
Παυσίμαχος	person
Παυσανίαν	person
Παυσανίας	person
Παυσανίου	person
Παυσανίᾳ	person
Παφίη	place
Παύλου	person
Παύσωνι	person
Παύσωνος	person
Παῦλον	person
Πείσανδρον	person
Πείσανδρος	person
Πειθοῖ	person
Πειθοῦς	person
Πειθὼ	person
Πειρήνην	person
Πειρήνης	person
Πειρίθου	person
Πειρίθουν	person
Πειρίθῳ	person
Πειραιέως	person, place
Πειραιεῖ	person, place
Πειραιᾶ	person, place
Πειραιῶς	person, place
Πειριθόοιο	person
Πεισάνδρῳ	person
Πεισίστρατον	person
Πεισίστρατος	person
Πεισιστράτου	person
Πελάγοντος	person
Πελίου	person
Πελίᾳ	person
Πελασγὸν	person
Πελασγῷ	person
Πελληνεύς	person, place
Πελοποννησιακοῦ	person
Πελοποννησιακὸν	person
Πελοποννησιακῶς	person
Πενθέα	person
Πεντετηρίς	person
Περίανδρον	person
Περίανδρος	person
Περίνθιος	ethnic, person
Περγάμου	person, place
Περγάμῳ	person, place
Περγαμηνός	ethnic, person
Περδίκκαν	person
Περδίκκας	person
Περδίκκου	person
Περδίκκᾳ	person
Περιάνδρῳ	person
Περικλέα	person
Περικλέης	person
Περικλέους	person
Περικλείτου	person
Περικλεῖ	person
Περικλῆς	person
Περικτιόνη	person
Περιμήδην	person
Περκώτην	person
Περσέα	person
Περσέος	person
Περσέως	person
Περσαίου	person
Περσαίῳ	person
Περσαῖον	person
Περσαῖος	person
Περσεφόνην	person
Περσεὺς	person
Περσικαὶ	person
Περσικαῖς	person
Περσικοῖς	person
Περσικοῦ	person
Περσικὰ	person
Περσικὴν	person
Περσικὸν	person
Περσικὸς	person
Περσικῆς	person
Περσικῇ	person
Περσικῶν	person
Περσικῷ	person
Περσὶς	place
Περσῶν	ethnic, person
Πετεὼ	person
Πετόσιριν	person
Πευκέστας	person
Πηγάσου	person
Πηγάσων	person
Πηγάσῳ	person
Πηλέα	person
Πηλείδη	person
Πηλεὺς	person
Πηλεῖ	person
Πηνειοῦ	person
Πηνειῷ	person
Πηνελόπεια	person
Πηνελόπην	person
Πηνελόπης	person
Πηνελόπῃ	person
Πιερίην	person, place
Πιερὶς	place
Πινδάρου	person
Πινδάρῳ	person
Πιξώδαρον	person
Πισαίοις	person
Πισαίου	person
Πιστίας	person
Πιτάνης	place
Πιτθέως	person
Πιτθεύς	person
Πιττακὸς	person
Πλάτων	person
Πλάτωνα	person
Πλάτωνι	person
Πλάτωνος	person
Πλαγγών	person
Πλείσταρχον	person
Πλεισθένει	person
Πλεισθένους	person
Πλειστόνικος	person
Πλεύρατον	person
Πληξίππου	person
Πλουτάρχου	person
Πλούταρχε	person
Πλούταρχον	person
Πλούταρχος	person
Πλούτωνα	person
Πνυταγόραν	person
Ποδαλείριος	person
Ποδῆν	person
Ποδῆς	person
Πολέμαρχος	person
Πολέμων	person
Πολέμωνά	person
Πολέμωνι	person
Πολίοχος	person
Πολυίδου	person
Πολυβιάδου	person
Πολυδεύκην	person
Πολυεύκτῳ	person
Πολυκλείᾳ	person
Πολυκράτει	person
Πολυκράτη	person
Πολυκράτην	person
Πολυκράτης	person
Πολυκράτους	person
Πολυκράτων	person
Πολυνείκης	person
Πολυσπέρχοντά	person
Πολυχάρμου	person
Πολύαρχος	person
Πολύβιος	person
Πολύβοιο	person
Πολύβου	person
Πολύδωρον	person
Πολύευκτον	person
Πολύευκτος	person
Πολύζηλος	person
Πολύιδος	person
Πολύκλειτος	person
Πολύκτορος	person
Πολύξενος	person
Πολύξενός	person
Πολύστρατον	person
Πολύφημος	person
Πολύχαρμος	person
Πομπηίου	person
Πομπηιόπολις	place
Πομπιλίου	person
Ποντίῳ	person
Ποντιανέ	person
Ποντιανοῦ	person
Ποντιανὸς	person
Ποντικοί	person
Ποντικούς	person
Ποντικοῦ	person
Ποντικὰ	person
Ποντικὸν	person
Ποντικὸς	person
Ποντικῆς	person
Ποντικῶν	person
Ποντικῷ	person
Ποντονόῳ	person
Ποσείδιππον	person
Ποσείδιππος	person
Ποσειδάωνι	person, place
Ποσειδάωνος	person, place
Ποσειδίππῳ	person
Ποσειδεῶνος	person, place
Ποσειδωνίου	person
Ποσειδώνιον	person
Ποσειδώνιος	person
Ποσειδῶ	person, place
Ποσειδῶν	person, place
Ποσειδῶνι	person, place
Ποσειδῶνος	person, place
Ποστουμίου	person
Ποτίδαιαν	person
Πράξιλλα	person
Πρίαμος	person
Πρίαμόν	person
Πρίαπος	person, place
Πρίηπος	person, place
Πραξαγόρας	person
Πραξαγόρου	person
Πραξιτέλης	person
Πραξιτέλους	person
Πρατίναν	person
Πρατίνας	person
Πρεπέλαον	person
Πριάμῳ	person
Πριάπου	person, place
Πριάπῳ	person, place
Προδίκου	person
Προιτίδας	person
Προκλέι	person
Προκλέους	person
Προμαθίδας	person
Προμαθεῖ	person
Προμηθέα	person
Προμηθέως	person
Προμηθεῖ	person
Προνόμου	person
Προτάγορας	person
Προυσίου	person
Πρυτάνιδι	person
Πρυτάνιδος	person
Πρωτέας	person
Πρωτέου	person
Πρωτέως	person
Πρωτέᾳ	person
Πρωταγορίδης	person
Πρωταγορίδου	person
Πρωταγόραν	person
Πρωταγόρας	person
Πρωταγόρου	person
Πρωταγόρᾳ	person
Πρωτεσιλάῳ	person
Πρωτεὺς	person
Πρωτεῖ	person
Πρόδικον	person
Πρόδικος	person
Πρόμαχος	person
Πρόνομος	person
Πρόξενος	person
Πρώταρχε	person
Πρώταρχος	person
Πρῶτις	person
Πτολεμαΐδα	place
Πτολεμαίδος	place
Πτολεμαίου	person
Πτολεμαίῳ	person
Πτολεμαῖε	person
Πτολεμαῖος	person, place
Πτολεμαῖόν	person
Πυγμαλίωνι	person
Πυθέα	person
Πυθέας	person
Πυθία	person
Πυθίαν	person
Πυθίας	person
Πυθίου	person
Πυθαίνετος	person
Πυθαγόραν	person
Πυθαγόρας	person
Πυθαγόρην	person
Πυθαγόρης	person
Πυθαγόρου	person
Πυθιάδα	person
Πυθικοῦ	person, place
Πυθικός	person, place
Πυθικὴν	person, place
Πυθικὸν	person, place
Πυθικῇ	person, place
Πυθιονίκη	person
Πυθιονίκην	person
Πυθιονίκης	person
Πυθοδώρου	person
Πυθοκλείδης	person
Πυθοκλεῖ	person
Πυθόδηλος	person
Πυθόδωρος	person
Πυθόνικος	person
Πυλάδην	person
Πυλάδου	person
Πυργίων	person
Πυριλάμπης	person
Πυριλάμπους	person
Πόλλιδι	person
Πόλλιν	person
Πόλλιος	person
Πόσειδον	person, place
Πόσσις	person
Πύθερμον	person
Πύθερμος	person
Πύθιον	person
Πύθιος	person
Πύθων	person
Πύθωνι	person
Πύθωνός	person
Πύλαι	place
Πύρρανδρος	person
Πύρρου	person
Πύρρων	person
Πώλος	person
Πᾶνα	person
ΡΟΔΙΑΣ	person
ΡΟΔΩΝ	person, place
ΣΕΛΕΥΚΙΣ	person, place
ΣΥΒΑΡΙΤΩΝ	person
Σάμιοι	person, place
Σάμιον	person, place
Σάμιός	person, place
Σάμον	person, place
Σάμου	person, place
Σάμῳ	person, place
Σάραμβος	person
Σάτυροι	person, place
Σάτυρον	person, place
Σάτυρος	person, place
Σέλευκον	person
Σέλευκος	person
Σίβυλλαν	person
Σίγειον	place
Σίκιννόν	person
Σίκιννός	person
Σίκων	person
Σίλλακος	person
Σίμου	person
Σίμων	person
Σίνιδος	person
Σίσυφος	person
Σαβάζιε	person
Σαβῖνος	person
Σακάδας	person
Σαλαμίνιοι	ethnic, person
Σαλαμίνιος	ethnic, person
Σαλαμῖνι	person, place
Σαλαμῖνος	person, place
Σαλμωνεῖ	person
Σαμία	person, place
Σαμίαν	person, place
Σαμίας	person, place
Σαμίοις	person, place
Σαμίου	person, place
Σαμίους	person, place
Σαμίων	person, place
Σανδρόκοττόν	person
Σαννυρίων	person
Σαπφοῖ	person
Σαπφοῦς	person
Σαπφὼ	person
Σαρδανάπαλλον	person
Σαρδανάπαλλος	person
Σαρδαναπάλλου	person
Σαρδαναπάλλῳ	person
Σαρδόνα	place
Σαρπηδόνα	person
Σαρπηδόνος	person
Σαρπηδὼν	person
Σατραβάτης	person
Σατυρίσκος	person
Σατύρα	person
Σατύροις	person, place
Σατύρου	person, place
Σατύρους	person, place
Σατύρων	person, place
Σαυρία	person, place
Σαυρίας	person
Σεβαστοῦ	person
Σειρίου	person
Σειρίτης	person
Σεκούνδου	person
Σεκοῦνδος	person
Σελεύκου	person
Σελεύκῳ	person
Σελινούντιος	ethnic, person
Σεμέλα	person
Σεμέλας	person
Σεμέλης	person
Σεμέλῃ	person
Σεμιράμιδος	person
Σεύθην	person
Σεύθης	person
Σεύθου	person
Σεύθῃ	person
Σημωνίδης	person
Σημωνακτίδης	person
Σηπιὰς	place
Σηστοῦ	place
Σηστὸν	place
Σθένελός	person
Σθενέλου	person
Σθενεβοίας	person
Σθενεβοίᾳ	person
Σιδοῦς	place
Σιδωνίου	place
Σιδωνίων	place
Σιδώνια	place
Σιδώνιον	place
Σιδώνιός	place
Σιδῶνος	place
Σικανοῖς	person
Σικελίαν	person, place
Σικελίας	person, place
Σικελίᾳ	person, place
Σικελοῖς	ethnic, person
Σικελοῦ	ethnic, person
Σικελός	ethnic, person
Σικελὸν	ethnic, person
Σικελῶν	ethnic, person
Σικυωνίοις	place
Σικυωνίου	place
Σικυωνίων	place
Σικυωνίῳ	place
Σικυώνια	place
Σικυώνιοι	place
Σικυώνιον	place
Σικυώνιος	place
Σικυῶνι	place
Σικυῶνος	place
Σιλανός	person
Σιληνοί	person
Σιληνός	person
Σιληνὸν	person
Σιληνῶν	person
Σιμάριστος	person
Σιμία	person
Σιμίας	person
Σιμαρίστου	person
Σιμμίας	person
Σιμωνίδη	person
Σιμωνίδην	person
Σιμωνίδης	person
Σιμωνίδου	person
Σινωπεὺς	person
Σινώπην	person, place
Σινώπης	person, place
Σινώπῃ	person, place
Σισύφου	person
Σιτάλκαν	person
Σιτάλκου	person
Σκάμων	person
Σκίρας	person
Σκίρπαλος	person
Σκίρωνι	person, place
Σκαμάνδρου	person, place
Σκιπίων	person
Σκιπίωνα	person
Σκιπίωνι	person
Σκιράδος	person
Σκιώνη	person, place
Σκυθικὰ	person
Σκυθικὴν	person
Σκυθικῷ	person
Σκυθῖνος	person
Σκυθῶν	ethnic, person
Σκόπα	person
Σκύθαι	ethnic, person
Σκύθαις	ethnic, person
Σκύθαισιν	ethnic, person
Σκύθας	ethnic, person
Σκύθην	ethnic, person
Σκύθης	ethnic, person
Σκύθῃ	ethnic, person
Σκύλαξ	person, place
Σκύλλα	person
Σκύλλαν	person
Σκύλλης	person
Σκύλλῃ	person
Σκύμνος	person
Σκύρου	person, place
Σμικρίνης	person
Σμικυθίων	person
Σμινδυρίδης	person
Σμινθείων	place
Σμυρναία	ethnic, person
Σμυρναῖος	ethnic, person
Σουνίῳ	person, place
Σουνιεῖς	person
Σοφοκλέα	person
Σοφοκλέει	person
Σοφοκλέους	person
Σοφοκλεῖ	person
Σοφοκλῆς	person
Σοφόκλεις	person
Σοῦσα	person, place
Σπάρτακος	person
Σπάρτῃ	person, place
Σπαρτιάταις	ethnic, person
Σπαρτιάτην	ethnic, person
Σπαρτιάτης	ethnic, person
Σπαρτιατῶν	ethnic, person
Σπαρτιᾶται	ethnic, person
Σπεύσιππον	person
Σπεύσιππος	person
Στάφυλος	person
Στέφανος	person
Στήσανδρον	person
Στίλπων	person
Στίλπωνος	person
Σταγόνιον	person
Σταθμοὶ	place
Στασίχορος	person
Στασῖνος	person
Στησίμβροτος	person
Στησίχορον	person
Στησίχορος	person
Στησιμβρότος	person
Στησιχόρου	person
Στησιχόρῳ	person
Στράτιε	ethnic, place
Στράτιον	ethnic, person
Στράτον	place
Στράττις	person
Στράτων	person, place
Στράτωνι	person
Στράτωνος	person, place
Στρατοκλῆς	person
Στρατονίκου	person
Στρατόλας	person
Στρατόνικον	person
Στρατόνικος	person
Στρομβιχίδη	person
Στρυμών	place
Συβάρει	person, place
Συβάρεως	person, place
Συβαρίταις	person
Συβαρίτας	person
Συβαρίτην	person
Συβαρίτης	person
Συβαρίτου	person
Συβαρῖτα	person
Συβαρῖται	person
Συράκουσαι	place
Συρίαν	place
Συρίας	place
Συρίης	place
Συρίᾳ	place
Συρακοσία	ethnic, person
Συρακοσίαν	ethnic, person
Συρακοσίας	ethnic, person
Συρακοσίοις	ethnic, person
Συρακοσίου	ethnic, person
Συρακοσίους	ethnic, person
Συρακοσίων	ethnic, person
Συρακουσῶν	place
Συρακούσαις	place
Συρακούσας	place
Συρακόσιοι	ethnic, person
Συρακόσιον	ethnic, person
Συρακόσιος	ethnic, person
Συριακοῦ	person
Συριακῆς	person
Σφίγγα	person
Σφίγξ	person
Σφαῖρον	person
Σφαῖρος	person
Σφηττίῳ	person
Σφιγγί	person
Σφιγγὸς	person
Σφοδρίου	person
Σωκλῆς	person
Σωκράτει	person
Σωκράτη	person
Σωκράτην	person
Σωκράτης	person
Σωκράτους	person
Σωκρατικοῦ	person
Σωκρατικὴ	person
Σωκρατικὸν	person
Σωκρατικὸς	person
Σωκρατικῆς	person
Σωπάτρου	person
Σωσίβιος	person
Σωσίθεος	person
Σωσίᾳ	person
Σωσιβίου	person
Σωσιγένους	person
Σωσικράτει	person
Σωσικράτης	person
Σωσικράτους	person
Σωσιφάνης	person
Σωστράτου	person
Σωτάδης	person
Σωτάδου	person
Σωτίων	person
Σωτηρίδην	person
Σωτηρίδου	person
Σωφίλῳ	person
Σωφρονίσκος	person
Σωφρονίσκου	person
Σωφροσύνα	person
Σόλων	person
Σόλωνα	person
Σόλωνος	person
Σόφων	person
Σύαγρε	person
Σύβαριν	person, place
Σύλλαν	person
Σύλλας	person
Σύρον	ethnic, place
Σύρος	ethnic, person, place
Σύρους	ethnic, person, place
Σώκρατες	person
Σώπατρος	person
Σώσιππος	person
Σώστρατον	person
Σώστρατος	person
Σώφιλος	person
Σῆμος	person
Σῖμον	person
Σῖρις	place
Σῶσις	person
ΤΙΘΩΝΟΝ	person
Τάλων	person
Τάνταλον	person
Τάνταλος	person
Τάραντα	person, place
Τάραντι	person, place
Τάραντος	person, place
Τάρταρον	person
Τέλεσις	person
Τέμπη	place
Τέρπανδρον	person
Τέρπανδρός	person
Τέχνων	person
Τήλεφον	person
Τήλεφος	person
Τήλυος	person
Τήριλλος	person
Τίμαιαν	person
Τίμαιε	person
Τίμαιον	person
Τίμαιος	person
Τίμαρχος	person
Τίμων	person
Τίμωνα	person
Τίμωνι	person
Τίμωνος	person
Τίνδιον	place
Ταλθύβιον	person
Ταλθύβιος	person
Ταντάλου	person
Ταραντῖνος	ethnic, person
Ταρσὸν	place
Ταρτάρου	person
Ταυρέαν	person
Ταυρέας	person
Ταυρέᾳ	person
Ταχὼς	person
Τείσανδρος	person
Τείσων	person
Τεγέας	place
Τειρεσίαν	person
Τελένικος	person
Τελέσιλλα	person
Τελέστης	person
Τελέστου	person
Τελαμών	person, place
Τελεσίου	person
Τελεσίᾳ	person
Τελλίας	person
Τερπάνδρου	person
Τερψίων	person
Τερψικλῆς	person
Τεύκρου	person
Τεύκρῳ	person
Τεῦκρος	person
Τηλέγονον	person
Τηλέμαχε	person
Τηλέμαχον	person
Τηλέμαχος	person
Τηλέφῳ	person
Τηλαυγές	person
Τηλεκλείδης	person
Τηλεκλείδου	person
Τηλεμάχου	person
Τηλεμάχῳ	person
Τηλεφάνην	person
Τηλεφάνης	person
Τηρέα	person
Τηρεὺς	person
Τιάραι	place
Τιβερίου	person
Τιγράνην	person
Τιγράνου	person
Τιθραύστῃ	person
Τιθωνοῦ	person
Τιθωνῷ	person
Τιθύμαλλος	person
Τιμάρχου	person
Τιμαίῳ	person
Τιμαγόραν	person
Τιμαγόρᾳ	person
Τιμασίων	person
Τιμαχίδας	person
Τιμαχίδᾳ	person
Τιμοθέου	person
Τιμοθέῳ	person
Τιμοκλέα	person
Τιμοκλῆς	person
Τιμοκράτην	person
Τιμοκράτης	person
Τιμοκρέων	person
Τιμολάου	person
Τιμόθεον	person
Τιμόθεος	person
Τιμόκρατες	person
Τιμόμαχος	person
Τισίας	person
Τισσαφέρνου	person
Τιτάνων	person
Τιτήνων	person
Τιταρήσιον	person
Τιτυὸν	person
Τληπολέμου	person
Τμώλου	person, place
Τουβέρων	person
Τράλλεις	place
Τράμβηλον	person
Τρίτων	person
Τρίτωνες	person, place
Τρίτωνος	person, place
Τραιανῷ	person
Τραχινίαις	place
Τραχῖνος	place
Τριβαλλοῖς	place
Τριπτολέμου	person
Τριπτολέμῳ	person
Τριόπᾳ	person
Τροίαν	place
Τροίας	place
Τροίῃ	place
Τροιζήνιος	ethnic, person
Τροιζηνίοις	ethnic, person
Τροιζῆνα	place
Τροιζῆνι	place
Τροιζῆνος	place
Τροφωνίου	person
Τροφωνίῳ	person
Τρωίλου	person
Τρωίλῳ	person
Τρύφη	person
Τρύφων	person
Τρύφωνι	person
Τρύφωνος	person
Τρῶας	ethnic, place
Τυδείδην	person
Τυδείδης	person
Τυνδάρεων	person, place
Τυνδάριχος	person
Τυνδαρὶς	place
Τυροῖ	person, place
Τυρρηνούς	person
Τυρρηνοὶ	person
Τυρρηνοῖς	person
Τυρρηνόν	person
Τυρρηνῶν	person
Τυρρηνῷ	person
Τυρταίου	person
Τυφών	person, place
Τυφῶνος	place
Τύριος	ethnic, person
Τύρου	person, place
Τύχωνι	person
Τῆλος	place
ΦΟΙΝΙΚΟΣ	ethnic, person, place
Φάλαικος	person
Φάλανθον	person
Φάλανθος	person, place
Φάλαριν	person
Φάνιον	person
Φάρῳ	person, place
Φάσηλις	place
Φάσιδος	person
Φάσων	person
Φάυλλος	person
Φάυλλόν	person
Φάων	person
Φήμιον	person
Φήμιος	person
Φίλαγρος	person
Φίλιννα	person
Φίλινναν	person
Φίλιπποι	place
Φίλιππον	person
Φίλιππος	person
Φίλλις	person
Φίλωνα	person
Φαέθων	person
Φαίακας	person
Φαίακες	person
Φαίακος	person
Φαίαξ	person
Φαίαξι	person
Φαίδραν	person
Φαίδρας	person
Φαίδρου	person
Φαίδρῳ	person
Φαίδων	person
Φαίδωνα	person
Φαίδωνι	person
Φαίδωνος	person
Φαιάκων	person
Φαιδώνδας	person
Φαινέστιος	person
Φαινίας	person
Φαινίου	person
Φαιναρέτη	person
Φακᾶς	person
Φαλάνθου	person
Φαλάνθῳ	person
Φαλάριδι	person
Φαλήρου	person
Φαλερίνου	person
Φαλερίνῳ	person
Φαλερῖνος	person
Φαληρέα	person
Φαληρέως	person
Φαληρεὺς	person
Φανίᾳ	person
Φανοσθένη	person
Φανοσθένης	person
Φανόδημος	person
Φανόκριτος	person
Φαρνάβαζον	person
Φαρναβάζου	person
Φαρσαλίᾳ	ethnic, person
Φαῖδρον	person
Φαῖδρος	person
Φείδιππον	person
Φείδιππος	person
Φείδων	person
Φειδία	person
Φειδίας	person
Φειδίου	person
Φειδίππου	person
Φειδόστρατος	person
Φερένικος	person
Φεραία	ethnic, place
Φερεκράτει	person
Φερεκράτη	person
Φερεκράτην	person
Φερεκράτης	person
Φερεκράτους	person
Φερεκύδης	person
Φερσεφόνεια	person
Φερσεφόνῃ	person
Φθίας	place
Φθιώτην	person
Φθιῶτα	person
Φιλάδελφός	person
Φιλάρχῳ	person
Φιλέας	person, place
Φιλέταιρος	person
Φιλήβος	person
Φιλήβῳ	person
Φιλήμονα	person
Φιλήμονι	person
Φιλήμονος	person
Φιλήμων	person
Φιλίννῃ	person
Φιλίππου	person
Φιλίππῳ	person, place
Φιλίσκον	person
Φιλίσκος	person
Φιλίσκῳ	person
ΦιλαΙδης	person
Φιλαδέλφου	person
Φιλαινίδι	person
Φιλαινίδος	person
Φιλαινὶς	person
Φιλαῖον	person
Φιλεταίρου	person
Φιλεταίρῳ	person
Φιλητᾶς	person
Φιλιππίδην	person
Φιλιππίδης	person
Φιλιππίδου	person
Φιλιστίδης	person
Φιλιστίων	person
Φιλοκλῆς	person
Φιλοκράτην	person
Φιλοκράτης	person
Φιλοκτήτην	person
Φιλοκτήτῃ	person
Φιλομήλου	person
Φιλομήτορα	person
Φιλομήτορι	person
Φιλοξένου	person
Φιλοξένῳ	person
Φιλοπάτορα	person
Φιλοπάτορι	person
Φιλοπάτορος	person
Φιλοπάτωρ	person
Φιλοστέφανος	person
Φιλούμενε	person
Φιλυλλίου	person
Φιλωνίδης	person
Φιλωνίδου	person
Φιλωνίδῃ	person
Φιλόλαός	person
Φιλόμηλος	person
Φιλόμνηστος	person
Φιλόξενε	person
Φιλόξενον	person
Φιλόπαππον	person
Φιλόστρατος	person
Φιλόχορος	person
Φιλύλλιος	person
Φιλῖνος	person
Φιλῖνόν	person
Φινεῖ	person
Φλιάσιον	place
Φοίνικα	ethnic, person, place
Φοίνικας	ethnic, person, place
Φοίνικες	ethnic, person, place
Φοίνικι	ethnic, person, place
Φοίνιξιν	ethnic, person, place
Φοινίκη	person, place
Φοινίκιον	person
Φοινίκων	ethnic, person, place
Φοινίσσαις	ethnic, person, place
Φοινικίδην	person
Φοινικίδης	person
Φοινικίδῃ	person
Φορμίσιος	person
Φορμίων	person
Φορμίωνα	person
Φορμίωνι	person
Φορμίωνος	person
Φορωνίδος	person
Φοῖβε	person
Φοῖβον	person
Φοῖβος	person
Φοῖνιξ	ethnic, person, place
Φράστορι	person
Φρίξος	person, place
Φρίξῳ	person
Φρεαρρίῳ	person
Φρυγί	ethnic, person
Φρυγίας	person, place
Φρυγίου	person, place
Φρυγίους	person, place
Φρυγίων	person, place
Φρυγίᾳ	person, place
Φρυγίῳ	person
Φρυγὸς	ethnic, person
Φρυγῶν	ethnic, person
Φρυνίχου	person
Φρυνίων	person
Φρυνίωνος	person
Φρυξὶν	ethnic, person
Φρύγα	ethnic, person
Φρύγας	ethnic, person
Φρύγες	ethnic, person
Φρύγιον	person, place
Φρύγιος	person, place
Φρύνας	person
Φρύνη	person
Φρύνην	person
Φρύνης	person
Φρύνιδος	person
Φρύνιχος	person
Φρύνωνος	person
Φρὺξ	ethnic, person
Φυλάρχου	person
Φυλάρχῳ	person
Φυλείδης	person
Φυλεύς	person
Φυλότιμος	person
Φυλὼ	person
Φυρομάχου	person
Φυρόμαχον	person
Φυρόμαχος	person
Φωκέως	person
Φωκίδα	person, place
Φωκίωνος	person
Φωκαέων	person
Φωκαεὺς	person
Φωκαεῖς	person
Φωκεὺς	person
Φωκεῖς	person
Φωκεῦσιν	person
Φωκικῶν	place
Φωκυλίδης	person
Φωκυλίδου	person
Φόλος	person
Φόλῳ	person
Φόρβαντι	person
Φόρβαντος	person
Φόρβας	person
Φόρμος	person
Φύλακος	person
Φύλαρχον	person
Φύλαρχος	person
Φᾶνος	person
Φῶκον	person
Φῶκος	person
Χάραξον	person
Χάρης	person, place
Χάρητι	person
Χάρητος	person
Χάρμον	person
Χάρμος	person
Χάρμου	person
Χάρυβδιν	place
Χάρυβδις	place
Χάρων	person
Χάρωνι	person
Χήρᾳ	person
Χίας	ethnic, person, place
Χίμαιρα	person, place
Χίμαιραν	person
Χίοις	place
Χίου	place
Χίων	ethnic, person
Χίῳ	place
Χαβρίας	person
Χαβρίου	person
Χαιρέας	person
Χαιρέστρατος	person
Χαιρέφανες	person
Χαιρήμονα	person
Χαιρήμονος	person
Χαιρήμων	person
Χαιρεδήμος	person
Χαιρεκράτης	person
Χαιρεφάνης	person
Χαιρεφῶν	person
Χαιρεφῶντα	person
Χαιρεφῶντι	person
Χαιρεφῶντος	person
Χαλκίδα	person, place
Χαλκίδι	person, place
Χαλκίδος	person, place
Χαλκεῖά	place
Χαλκηδών	place
Χαλκιδέων	ethnic, place
Χαλκιδεὺς	ethnic, person
Χαλκιδεῖς	ethnic, place
Χαλκιοίκου	person
Χαλκώδοντος	person
Χαλυβώνιον	person
Χαμαιλέων	person
Χαράξου	person
Χαρίλαν	person
Χαριάδης	person
Χαριδήμου	person
Χαρικλείδης	person
Χαρικλῆς	person
Χαρμίδην	person
Χαρμίδης	person
Χαρμίδῃ	person
Χαρμαντίδης	person
Χαρμύλος	person
Χαρώνδου	person
Χαρῖνος	person
Χείρωνα	person
Χείρωνι	person
Χείρωσι	person
Χειρίσοφον	person
Χερρονησίτου	person
Χερρονησίτῃ	person
Χιωνίδην	person
Χιωνίδης	person
Χοιρίλον	person
Χοιρίλος	person
Χορόνικος	person
Χρέμης	person
Χρυσίδα	person
Χρυσίππου	person
Χρυσίππῳ	person
Χρυσίς	person
Χρυσηίδα	person
Χρυσογόνου	person
Χρυσοχόῳ	person
Χρυσόγονος	person
Χρύσιλλα	person
Χρύσιππον	person
Χρύσιππος	person
Χώνη	place
Χῖα	ethnic, person, place
Χῖαι	ethnic, person, place
Χῖοι	place
Χῖος	place
Ψαμάθη	person
Ψαμμήτιχον	person
Ἀέθλιος	person
Ἀίδα	person
Ἀίδαο	person
Ἀίδῃ	person
Ἀβδηρίτην	person
Ἀβδηρίτης	person
Ἀβδηρίτου	person
Ἀβδηρῖται	person
Ἀβύδου	place
Ἀβύδῳ	place
Ἀγάθων	person
Ἀγάθωνα	person
Ἀγάθωνι	person
Ἀγάθωνος	person
Ἀγέλοχος	person
Ἀγήτορα	person
Ἀγίας	person
Ἀγαθαρχίδης	person
Ἀγαθοκλέα	person
Ἀγαθοκλέους	person, place
Ἀγαθοκλεῖ	person
Ἀγαθοκλῆς	person
Ἀγαθόκλεια	person
Ἀγαθόκλειαν	person
Ἀγαλλὶς	person
Ἀγαμέμνονί	person
Ἀγαμέμνονα	person
Ἀγαμέμνονος	person
Ἀγαμέμνων	person
Ἀγαρίστη	person
Ἀγαρίστης	person
Ἀγησάρχου	person
Ἀγησίλαος	person
Ἀγησιλάου	person
Ἀγησιλάῳ	person
Ἀγλαοσθένης	person
Ἀγλαοφῶντος	person
Ἀγχίσαο	person
Ἀγχίσῃ	person
Ἀγχιάλην	person
Ἀγχιάλῃ	person
Ἀγύρριον	person
Ἀγύρριος	person
Ἀδαῖον	person
Ἀδαῖος	person
Ἀδείμαντον	person
Ἀδείμαντος	person
Ἀδειμάντου	person
Ἀδμήτη	person
Ἀδμήτην	person
Ἀδμήτης	person
Ἀδμήτου	person
Ἀδμήτῳ	person
Ἀδράστῳ	person
Ἀδρήστη	person
Ἀδρίαν	person
Ἀδριανοῦ	person
Ἀδριανὸς	person
Ἀδριανῷ	person
Ἀδώνιδι	person, place
Ἀδώνιδος	person, place
Ἀερόπην	person
Ἀθάμαντι	person
Ἀθάμαντος	person
Ἀθάνα	person, place
Ἀθάναν	person, place
Ἀθήναιε	ethnic
Ἀθήναιος	ethnic
Ἀθήναις	person, place
Ἀθήνας	person, place
Ἀθήνη	person, place
Ἀθήνησι	person, place
Ἀθαμᾶνες	ethnic, place
Ἀθηνίων	person
Ἀθηνίωνα	person
Ἀθηνίωνι	person
Ἀθηνίωνος	person
Ἀθηναίας	person, place
Ἀθηναίης	person, place
Ἀθηναίων	person, place
Ἀθηναῖον	ethnic
Ἀθηνοκλῆς	person
Ἀθηνόδωρος	person
Ἀθηνᾶ	person, place
Ἀθηνᾶν	person, place
Ἀθηνῶν	person, place
Ἀθῆναι	person, place
Ἀιαντόδωρος	person
Ἀισχίνης	person
Ἀκάνθιος	ethnic, person
Ἀκέστιος	person
Ἀκαδήμειαν	person, place
Ἀκαδημίαν	person, place
Ἀκαδημίας	person, place
Ἀκαδημίᾳ	person, place
Ἀκαδημαικοῦ	person
Ἀκαδημαικὸν	person
Ἀκαδημαικὸς	person
Ἀκαδημείας	person, place
Ἀκαδημείᾳ	person, place
Ἀκεσίας	person
Ἀκεσᾶ	person
Ἀκουμενός	person
Ἀκρίσιος	person
Ἀκρισίου	person
Ἀκροκόρινθον	place
Ἀκρότατον	person
Ἀκρότατος	person
Ἀκταίωνος	person
Ἀκύλλιος	person
Ἀλέξανδρε	person
Ἀλέξανδρον	person
Ἀλέξανδρος	person
Ἀλέξαρχος	person
Ἀλέξιδι	person
Ἀλέξιδος	person
Ἀλαλά	person
Ἀλβανὸς	ethnic, place
Ἀλβανῷ	ethnic, place
Ἀλεκτρυὼν	person
Ἀλεξάνδρου	person, place
Ἀλεξάνδρῳ	person
Ἀλεξαμενοῦ	person
Ἀλεξαμενόν	person
Ἀλεξαμενός	person
Ἀλεξανδρέα	ethnic, place
Ἀλεξανδρίδα	person
Ἀλεξῖνος	person
Ἀλθαίᾳ	person
Ἀλκάνδρη	person
Ἀλκέτας	person
Ἀλκήστιδι	person
Ἀλκίνου	person
Ἀλκίνουν	person
Ἀλκίνους	person
Ἀλκίππη	person
Ἀλκίφρων	person
Ἀλκαίου	person
Ἀλκαίῳ	person
Ἀλκαῖος	person
Ἀλκείδην	person
Ἀλκείδης	person
Ἀλκιβιάδας	person
Ἀλκιβιάδην	person
Ἀλκιβιάδης	person
Ἀλκιβιάδου	person
Ἀλκιβιάδῃ	person
Ἀλκιδάμας	person
Ἀλκινόοιο	person
Ἀλκινόου	person
Ἀλκινόῳ	person
Ἀλκμάων	person
Ἀλκμέων	person
Ἀλκμέωνα	person
Ἀλκμήνης	person
Ἀλκμήνῃ	person
Ἀλκμαίων	person
Ἀλκμαίωνι	person
Ἀλκμαιωνίδα	person
Ἀλκμὰν	person
Ἀλκμᾶνα	person
Ἀλκμᾶνι	person
Ἀλκμᾶνος	person
Ἀλκυονέα	person
Ἀλκυόνης	person
Ἀλυάττην	person
Ἀλυάττου	person
Ἀλφεσιβοίᾳ	person
Ἀμάραντος	person
Ἀμάσιδος	person
Ἀμάσιος	person
Ἀμαζόνος	person
Ἀμαζόσιν	person
Ἀμαλθείας	person
Ἀμαλθείᾳ	person
Ἀμβρακία	place
Ἀμβρακιώτας	person
Ἀμβρακιώτης	person
Ἀμεινίας	person
Ἀμειψίαν	person
Ἀμειψίας	person
Ἀμειψίου	person
Ἀμερίας	person
Ἀμμίτης	place
Ἀμμωνίου	person
Ἀμμώνιος	person
Ἀμοιβέως	person
Ἀμυμώνῃ	person
Ἀμφίκλου	person
Ἀμφίλοχον	person
Ἀμφίονα	person
Ἀμφίονος	person
Ἀμφίων	person
Ἀμφιάραον	person
Ἀμφιάραος	person
Ἀμφιαράου	person
Ἀμφιαράῳ	person
Ἀμφικλῆς	person
Ἀμφικράτης	person
Ἀμφικτύονα	person
Ἀμφικτύονος	person
Ἀμφιλόχῳ	person, place
Ἀμφιτρύων	person
Ἀμφιτρύωνι	person
Ἀμύκλαις	place
Ἀμύκλου	person
Ἀμύκῳ	person
Ἀμύντας	person
Ἀμύντορος	person
Ἀμύντου	person
Ἀνάνιον	person
Ἀνάνιος	person
Ἀνάξαρχόν	person
Ἀνάξιππος	person
Ἀνάχαρσι	person
Ἀνάχαρσιν	person
Ἀνάχαρσις	person
Ἀνίκητος	person
Ἀνίκιος	person
Ἀναδυομένην	person
Ἀνακρέοντα	person
Ἀνακρέοντι	person
Ἀνακρέοντος	person
Ἀνακρέων	person
Ἀνακρείοντα	person
Ἀνακυνδαράξεω	person
Ἀνανίου	person
Ἀναξάρχῳ	person
Ἀναξίλα	person
Ἀναξίλας	person
Ἀναξίμανδρος	person
Ἀναξαγόρας	person
Ἀναξαγόρου	person
Ἀναξανδρίδην	person
Ἀναξανδρίδης	person
Ἀναξανδρίδῃ	person
Ἀναξιμένης	person
Ἀναξιμένους	person
Ἀναξώ	person
Ἀνδοκίδης	person
Ἀνδρέας	person
Ἀνδρίσκος	person
Ἀνδροκλεῖ	person
Ἀνδροκύδης	person
Ἀνδρομέδας	person
Ἀνδρομέδᾳ	person
Ἀνδρομήδης	person
Ἀνδρονίκου	person
Ἀνδροσθένης	person
Ἀνδροτίων	person
Ἀνδροτίωνά	person
Ἀνδροτίωνος	person
Ἀνδρων	person
Ἀνδρόμαχον	person
Ἀνδρόμαχος	person
Ἀνδρόνικον	person
Ἀνδρόνικος	person
Ἀνθέας	person
Ἀνθείας	person
Ἀνθεμόκριτον	person
Ἀνθεστηριῶνα	person
Ἀνθηδών	place
Ἀννίβα	person
Ἀννίβαν	person
Ἀντήνορος	person
Ἀντήνωρ	person
Ἀντίγονον	person
Ἀντίγονος	person
Ἀντίδοτος	person
Ἀντίκλειαν	person
Ἀντίμοιρος	person
Ἀντίνοος	person
Ἀντίοχε	person
Ἀντίοχον	person
Ἀντίοχος	person
Ἀντίπατρος	person
Ἀνταίῳ	person
Ἀνταγόρα	person
Ἀνταγόρας	person
Ἀνταλκίδᾳ	person
Ἀντείας	person
Ἀντηνορίδης	person
Ἀντιγόνου	person
Ἀντιγόνῃ	person
Ἀντιγόνῳ	person
Ἀντιδότου	person
Ἀντικλείδης	person
Ἀντικλείδῃ	person
Ἀντιμάχου	person
Ἀντινόοιο	person
Ἀντιπάτρου	person
Ἀντιπάτρῳ	person
Ἀντισάρην	person
Ἀντισθένη	person
Ἀντισθένην	person
Ἀντισθένης	person
Ἀντισθένους	person
Ἀντιφάνει	person
Ἀντιφάνη	person
Ἀντιφάνην	person
Ἀντιφάνης	person
Ἀντιφάνους	person
Ἀντιφήμου	person
Ἀντιφῶν	person
Ἀντιφῶντι	person
Ἀντιφῶντος	person
Ἀντιόπην	person
Ἀντιόπῃ	person
Ἀντιόχου	person
Ἀντιόχῳ	person
Ἀντωνίῳ	person
Ἀντύλλῳ	person
Ἀντώνιον	person
Ἀξίοχος	person
Ἀξιοθέα	person
Ἀξιόνικος	person
Ἀξιόχου	person
Ἀξιόχῳ	person
Ἀπήμαντος	person
Ἀπία	person, place
Ἀπελλικῶν	person
Ἀπελλικῶντα	person
Ἀπελλῆς	person
Ἀπελλῇ	person
Ἀπολλοδώρου	person
Ἀπολλοδώρῳ	person
Ἀπολλοκράτης	person
Ἀπολλοφάνει	person
Ἀπολλοφάνη	person
Ἀπολλοφάνης	person
Ἀπολλωνίαν	person
Ἀπολλωνίου	person
Ἀπολλωνίᾳ	person
Ἀπολλωνίῳ	person
Ἀπολλόδωρον	person
Ἀπολλόδωρος	person
Ἀπολλώνιος	person
Ἀπολλώνιόν	person
Ἀπολλᾶς	person
Ἀπρίας	person
Ἀπρίου	person
Ἀπόλλων	person
Ἀπόλλωνα	person
Ἀπόλλωνι	person
Ἀπόλλωνος	person
Ἀράβια	person
Ἀράβιοι	person
Ἀράτου	person
Ἀρήτη	person
Ἀρίσταρχος	person
Ἀρίστιππε	person
Ἀρίστιππον	person
Ἀρίστιππος	person
Ἀρίστων	person
Ἀρίστωνά	person
Ἀρίστωνι	person
Ἀρίστωνος	person
Ἀρίφρονος	person
Ἀρίφρων	person
Ἀραρώς	person, place
Ἀρβάκην	person
Ἀρβάκης	person
Ἀρβάκου	person
Ἀργεία	ethnic, person, place
Ἀργείη	ethnic, person
Ἀργείοις	ethnic, person
Ἀργείου	ethnic, person
Ἀργείους	ethnic, person
Ἀργείων	ethnic, person
Ἀργεῖοι	ethnic, person
Ἀργεῖον	ethnic, person
Ἀργεῖος	ethnic, person
Ἀργολικὰ	person
Ἀργοναύτας	person
Ἀργοῖ	person
Ἀργᾶ	person
Ἀργᾶν	person
Ἀργᾶς	person
Ἀρδιαῖοι	place
Ἀρείου	person
Ἀρεθούσης	person, place
Ἀρεθούσῃ	person, place
Ἀρεοπαγίτας	person
Ἀρεοπαγίτῃ	person
Ἀρεοπαγιτικῷ	person
Ἀρετὰ	person
Ἀρετὴ	person
Ἀριάδνην	person
Ἀριάδνης	person
Ἀριάδνῃ	person
Ἀριάμνην	person
Ἀριγνώτου	person
Ἀριδαίου	person
Ἀριοβαρζάνου	person
Ἀριοβαρζάνῃ	person
Ἀριστάρχου	person
Ἀριστέα	person
Ἀριστέας	person
Ἀριστίαν	person
Ἀριστίας	person
Ἀριστίππου	person
Ἀριστίων	person, place
Ἀριστίωνος	person
Ἀρισταίου	person
Ἀρισταγόραν	person
Ἀρισταγόρας	person
Ἀρισταγόρου	person
Ἀρισταγόρᾳ	person
Ἀριστείδην	person
Ἀριστείδης	person
Ἀριστείδου	person
Ἀριστογείτονι	person
Ἀριστογείτονος	person
Ἀριστογείτων	person
Ἀριστοκλέα	person
Ἀριστοκλέους	person
Ἀριστοκλείας	person
Ἀριστοκλῆς	person
Ἀριστοκράτης	person
Ἀριστομάχου	person
Ἀριστομένης	person
Ἀριστονίκου	person
Ἀριστοξένου	person
Ἀριστοτέλει	person
Ἀριστοτέλη	person
Ἀριστοτέλην	person
Ἀριστοτέλης	person
Ἀριστοτέλους	person
Ἀριστοτελικοῦ	person
Ἀριστοτελικὸς	person
Ἀριστοφάνειος	person
Ἀριστοφάνη	person
Ἀριστοφάνην	person
Ἀριστοφάνης	person
Ἀριστοφάνους	person
Ἀριστοφῶν	person
Ἀριστόβουλος	person
Ἀριστόδημον	person
Ἀριστόδημος	person
Ἀριστόδωρος	person
Ἀριστόκλεια	person
Ἀριστόκριτος	person
Ἀριστόνικος	person
Ἀριστόξενον	person
Ἀριστόξενος	person
Ἀριστώνυμος	person
Ἀρκάδες	ethnic, place
Ἀρκαδίων	person
Ἀρκαδίωνα	person
Ἀρκαδίωνος	person
Ἀρκαδικὸς	ethnic, place
Ἀρκεσίλαον	person
Ἀρκεσίλαος	person
Ἀρκεσίλας	person
Ἀρκεσιλάου	person
Ἀρκεσιλάῳ	person
Ἀρκτοῦρον	person
Ἀρκτῖνος	person
Ἀρμενίδας	person
Ἀρμενίων	ethnic, person, place
Ἀρρηφόρῳ	person
Ἀρριανὸς	person
Ἀρριδαῖον	person
Ἀρσάκην	person
Ἀρσάκου	person
Ἀρσινόη	person, place
Ἀρσινόην	person
Ἀρσινόης	person
Ἀρτέμιδι	person, place
Ἀρτέμιδος	person, place
Ἀρτέμων	person
Ἀρταβάζου	person
Ἀρταξέρξην	person
Ἀρταξέρξης	person
Ἀρταξέρξῃ	person
Ἀρτεμίδωρος	person
Ἀρτεμίσιον	person, place
Ἀρτεμιδώρου	person
Ἀρτεμισίῳ	person, place
Ἀρχάγαθος	person
Ἀρχέδημος	person
Ἀρχέδικος	person
Ἀρχέλαος	person
Ἀρχέμαχος	person
Ἀρχέστρατον	person
Ἀρχέστρατος	person
Ἀρχίαν	person
Ἀρχίας	person
Ἀρχίλοχε	person
Ἀρχίλοχον	person
Ἀρχίλοχος	person
Ἀρχίμηλον	person
Ἀρχίου	person, place
Ἀρχίππη	person
Ἀρχίππῳ	person
Ἀρχεβούλου	person
Ἀρχεδίκη	person
Ἀρχεδίκῳ	person
Ἀρχελάου	person
Ἀρχελάῳ	person
Ἀρχεμόρου	person
Ἀρχεστράτου	person
Ἀρχεστράτῳ	person
Ἀρχεφῶν	person
Ἀρχιδάμου	person
Ἀρχιδάμῳ	person
Ἀρχιλόχου	person
Ἀρχιλόχῳ	person
Ἀρχιμήδην	person
Ἀρχιμήδης	person
Ἀρχιμήδους	person
Ἀρχιτέλει	person
Ἀρχωνίδης	person
Ἀρχύτα	person
Ἀρχύταν	person
Ἀρχύτας	person
Ἀρχύτου	person
Ἀρχῖνος	person
Ἀρύστας	person
Ἀσίας	person, place
Ἀσίδος	person
Ἀσίου	person
Ἀσίᾳ	person, place
Ἀσιάδος	person, place
Ἀσιανοὶ	person
Ἀσκληπιάδη	person
Ἀσκληπιάδην	person
Ἀσκληπιάδης	person
Ἀσκληπιάδου	person
Ἀσκληπιεῖον	place
Ἀσκληπιοῦ	person
Ἀσκληπιὸν	person
Ἀσκληπιὸς	person
Ἀσκληπιῷ	person
Ἀσπασία	person
Ἀσπασίαν	person
Ἀσπασίας	person
Ἀσπασίης	person
Ἀσσύριος	ethnic, person
Ἀστεροπαῖόν	person
Ἀστυάγην	person
Ἀστυάγους	person
Ἀστυάνακτα	person
Ἀστυάναξ	person
Ἀστυδάμας	person
Ἀστυδαμείας	person
Ἀστυπαλαίᾳ	person, place
Ἀστυπαλαιεῖς	ethnic, place
Ἀστύφιλος	person
Ἀσωπόδωρος	person
Ἀσώπιχόν	person
Ἀταλάντῃ	person
Ἀτθίδα	person
Ἀτθίδι	person
Ἀτθίδος	person
Ἀτθὶς	person
Ἀτρέως	person
Ἀτρεστίδας	person
Ἀτρεὺς	person
Ἀττάλου	person
Ἀτταγῖνος	person
Ἀττικάς	person
Ἀττικαὶ	person
Ἀττικαῖς	person
Ἀττικοὶ	person
Ἀττικοὺς	person
Ἀττικοῖς	person
Ἀττικοῦ	person
Ἀττικὰ	person
Ἀττικὴν	person
Ἀττικὸν	person
Ἀττικὸς	person
Ἀττικῆς	person
Ἀττικῇ	person
Ἀττικῶν	person
Ἀττικῷ	person
Ἀυτόλυκος	person
Ἀφείδαντα	person
Ἀφθόνητος	person
Ἀφρικανὸς	person
Ἀφρικανῷ	person
Ἀφροδίσια	person, place
Ἀφροδίσιον	person, place
Ἀφροδίτα	person
Ἀφροδίταν	person
Ἀφροδίτας	person
Ἀφροδίτη	person
Ἀφροδίτην	person
Ἀφροδίτης	person
Ἀφροδισίαν	person, place
Ἀφροδισίοις	person, place
Ἀφροδισίου	person, place
Ἀφροδισίων	person, place
Ἀφροδισίῳ	person, place
Ἀχίλλειον	place
Ἀχαίαν	ethnic, person
Ἀχαίας	ethnic, person
Ἀχαίης	ethnic, person
Ἀχαίᾳ	ethnic, person
Ἀχαιοὶ	ethnic, person
Ἀχαιοὺς	ethnic, person
Ἀχαιοῖσιν	ethnic, person
Ἀχαιοῦ	ethnic, person
Ἀχαιὸς	ethnic, person
Ἀχαιῶν	ethnic, person
Ἀχαιῷ	ethnic, person
Ἀχιλεύς	person, place
Ἀχιλεῦ	person, place
Ἀχιλλέα	person, place
Ἀχιλλέως	person, place
Ἀχιλλείων	place
Ἀχιλλεὺς	person, place
Ἀχιλλεῖ	person, place
Ἀχιλλεῦ	person, place
Ἀχιλῆα	person, place
Ἁλικαρνασσοῦ	place
Ἁρμοδίου	person
Ἁρμόδιον	person
Ἁρμόδιος	person
Ἁρπάγιον	place
Ἁρπάλου	person
Ἁρπάλῳ	person
Ἁρπαλύκη	person
Ἁρπαλύκην	person
Ἁρποκρατίων	person
Ἂρχιππος	person
Ἄβδηρα	place
Ἄβυδον	place
Ἄβυδος	place
Ἄγιδος	person
Ἄγνων	person
Ἄγρωνα	person
Ἄδραστον	person
Ἄδραστος	person
Ἄδρηστος	person
Ἄδωνιν	person, place
Ἄδωνις	person, place
Ἄθω	place
Ἄλεξιν	person
Ἄλεξις	person
Ἄλκηστιν	person
Ἄλκιμος	person
Ἄλκωνος	person
Ἄμασιν	person
Ἄμμωνα	place
Ἄμμωνος	place
Ἄμφιδος	person
Ἄμφιν	person
Ἄμφις	person
Ἄνακος	person
Ἄναυρον	place
Ἄνδρωνα	person, place
Ἄνθεια	person, place
Ἄνθειαν	person
Ἄνθου	place
Ἄννωνος	person
Ἄντεια	person
Ἄντειαν	person
Ἄνυτον	person
Ἄνυτος	person
Ἄπολλον	person
Ἄρατός	person
Ἄργει	place
Ἄργεος	place
Ἄργος	place
Ἄργους	person, place
Ἄρεα	person, place
Ἄρειον	person
Ἄρεος	person, place
Ἄρευς	person
Ἄρεως	person, place
Ἄρη	person, place
Ἄρηα	person, place
Ἄρηος	person, place
Ἄρης	person, place
Ἄρτεμι	person, place
Ἄρτεμιν	person, place
Ἄρτεμις	person, place
Ἄρχιππον	person
Ἄρχιππος	person
Ἄσιον	person
Ἄστρα	place
Ἄτης	person
Ἄτοσσαν	person
Ἄτταλον	person
Ἄτταλος	person
Ἄτυος	person
Ἄτῃ	person
Ἅιδην	person
Ἅιδου	person
Ἅρπαλον	person
Ἅρπαλος	person
Ἆγις	person
Ἐκφαντίδης	person
Ἐλάτεια	place
Ἐλευσινίοις	person
Ἐλευσινίων	person
Ἐλευσινίᾳ	person
Ἐλευσῖνα	person, place
Ἐλευσῖνι	person, place
Ἐλευσῖνος	person, place
Ἐλπήνορα	person
Ἐλπινίκῃ	person
Ἐμπεδοκλέα	person
Ἐμπεδοκλέους	person
Ἐμπεδοκλῆς	person
Ἐνδυμίωνος	person
Ἐντίμῳ	person
Ἐνυαλίοιο	person
Ἐπίγονος	person
Ἐπίκουρος	person
Ἐπίλυκος	person
Ἐπίνικος	person
Ἐπίχαρμον	person
Ἐπίχαρμος	person
Ἐπαίνετον	person
Ἐπαίνετος	person
Ἐπαμεινώνδου	person
Ἐπαμινώνδαν	person
Ἐπαμινώνδας	person
Ἐπαμινώνδου	person
Ἐπαρχίδης	person
Ἐπειὸν	ethnic, place
Ἐπιγένης	person
Ἐπικλέης	person
Ἐπικλέους	person
Ἐπικούρου	person
Ἐπικούρῳ	person
Ἐπικράτης	person
Ἐπικράτους	person
Ἐπιλύκου	person
Ἐπιμενίδης	person
Ἐπιμενίδου	person
Ἐπιχάρμου	person
Ἐπιχάρμῳ	person
Ἐπιχαρίδης	person
Ἐπωπέα	person
Ἐπωπεὺς	person
Ἐρίφῳ	person
ἘρασΙστρατος	person
Ἐρασίστρατον	person
Ἐρασίστρατος	person
Ἐρασινίδην	person
Ἐρατοσθένει	person
Ἐρατοσθένη	person
Ἐρατοσθένης	person
Ἐρατοσθένους	person
Ἐρατὼ	person
Ἐρετρίας	person
Ἐρετρίᾳ	person
Ἐρετριέα	person
Ἐρετριέων	person
Ἐρετριέως	person
Ἐρετριεὺς	person
Ἐρετριεῖ	person
Ἐρετρικοῦ	person
Ἐρετρικῷ	person
Ἐριφύλης	person
Ἐρξίας	person
Ἐρυθραῖος	ethnic, person
Ἐρυθρᾶς	place
Ἐρυθρᾷ	place
ἘρυξΙας	person
Ἐρυξίμαχον	person
Ἐρυξίμαχος	person
Ἐρυξιμάχου	person
Ἐρυσίχθονά	person
Ἐρυσίχθων	person
Ἐρύξιδος	person
Ἐφέσιος	ethnic, person
Ἐφίππου	person
Ἐφίππῳ	person
Ἐφιάλτῃ	person
Ἐχεμένης	person
Ἐχινάδες	place
Ἑκάβη	person
Ἑκάβην	person
Ἑκάλῃ	person
Ἑκάτης	person
Ἑκάτῃ	person
Ἑκαμήδη	person
Ἑκαταῖος	person
Ἑλένην	person
Ἑλένης	person
Ἑλένῃ	person
Ἑλικάων	person
Ἑλικών	person
Ἑλικὼν	place
Ἑλικῶνι	place
Ἑλικῶνος	place
Ἑλλάδα	place
Ἑλλάδι	place
Ἑλλάδος	place
Ἑλλάνικον	person
Ἑλλάνικος	person
Ἑλλάνων	ethnic, place
Ἑλλήνων	ethnic, place
Ἑλλήσποντον	place
Ἑλλήσποντος	place
Ἑλλαδικόν	person
Ἑλλησπόντου	place
Ἑλλησπόντῳ	place
Ἑλλὰς	place
Ἑρμίππῳ	person
Ἑρμαίου	person
Ἑρμαίων	person
Ἑρμαφρόδιτος	person
Ἑρμαῖ	person
Ἑρμαῖος	person
Ἑρμαῖς	person
Ἑρμείαν	person
Ἑρμείας	person
Ἑρμείου	person
Ἑρμείᾳ	person
Ἑρμογένης	person
Ἑρμοδώρου	person
Ἑρμοκλέους	person
Ἑρμοκράτης	person
Ἑρμοῦ	person
Ἑρμόδωρος	person
Ἑρμᾶς	person
Ἑρμῆν	person
Ἑρμῆς	person
Ἑρμῇ	person
Ἑρμῶναξ	person
Ἑσπέρου	person
Ἑστίας	person
Ἑστιαῖος	person
Ἑταιρείῳ	person
Ἑχεκράτης	person
Ἒραστος]	person
Ἒυδοξος	person
Ἒυφραῖος	person
Ἔμπεδός	person
Ἔντιμον	person
Ἔριδι	person
Ἔρωτα	person
Ἔφεσός	place
Ἔφιππος	person
Ἕκτορα	person
Ἕκτορι	person
Ἕκτορος	person
Ἕκτωρ	person
Ἕλλην	ethnic, place
Ἕλληνας	ethnic, place
Ἕλληνες	ethnic, place
Ἕλλησι	ethnic, place
Ἕλλησιν	ethnic, place
Ἕρμαρχον	person
Ἕρμιππον	person
Ἕρμιππος	person
Ἕρμων	person
Ἠετίωνος	person
Ἠλείας	ethnic, person
Ἠλεῖος	ethnic, person
Ἠοῖ	person
Ἠρακλείδης	person
Ἠριγόνῃ	person
Ἠριδανὸς	person
Ἠριφανίδος	person
Ἠριφανὶς	person
Ἠχοῖ	person
Ἠὼς	person
Ἡγήμονα	person
Ἡγήμονος	person
Ἡγήμων	person
Ἡγήσανδρον	person
Ἡγήσανδρος	person
Ἡγήσιππος	person
Ἡγησάνδρου	person
Ἡγησίαν	person
Ἡγησίας	person
Ἡγησίππου	person
Ἡγησιάνακτα	person
Ἡγησιάναξ	person
Ἡδύλη	person
Ἡλιόδωρος	person
Ἡνίοχος	person
Ἡράκλειαν	person
Ἡράκλειον	person
Ἡράκλειος	person
Ἡράκλεις	person
Ἡράκλειτον	person
Ἡράκλειτος	person
Ἡραίων	place
Ἡραίᾳ	place
Ἡρακλέα	person
Ἡρακλέης	person
Ἡρακλέος	person
Ἡρακλέους	person
Ἡρακλέων	person
Ἡρακλέωνος	person, place
Ἡρακλείας	person
Ἡρακλείδην	person
Ἡρακλείδης	person
Ἡρακλείδου	person
Ἡρακλείων	person
Ἡρακλείᾳ	person
Ἡρακλείῳ	person
Ἡρακλεώτας	person
Ἡρακλεώτην	person
Ἡρακλεώτης	person
Ἡρακλεώτου	person
Ἡρακλεῖ	person
Ἡρακλῆς	person
Ἡραῖον	place
Ἡροδίκῳ	person
Ἡροδότῳ	person
Ἡρωδιανὸς	person
Ἡρόδικον	person
Ἡρόδικος	person
Ἡρόδοτον	person
Ἡρόδοτος	person
Ἡρόδωρος	person
Ἡρόδωρόν	person
Ἡρόστρατος	person
Ἡρώνδας	person
Ἡσίοδος	person
Ἡσίοδόν	person
Ἡσιόδου	person
Ἡσιόδῳ	person
Ἡσιόνῃ	person
Ἡφαίστου	person, place
Ἡφαίστῳ	person, place
Ἡφαιστίων	person, place
Ἡφαιστίωνος	person
Ἤριννά	person
Ἥβας	person
Ἥβη	person
Ἥλιε	person
Ἥραν	person
Ἥρας	person
Ἥρᾳ	person
Ἥρῃ	person
Ἥφαιστον	person, place
Ἥφαιστος	person, place
Ἦλις	place
Ἰάκχου	person
Ἰάσονα	person
Ἰάσονος	person
Ἰάσων	person
Ἰήιον	person
Ἰαλέμῳ	person
Ἰαλυσῷ	person
Ἰανὸν	person
Ἰανὸς	person
Ἰαπύγων	ethnic, person, place
Ἰασίωνι	person
Ἰασεὺς	person
Ἰασοῦ	person
Ἰασῷ	person
Ἰατροκλέα	person
Ἰατροκλῆς	person
Ἰβηρικῷ	person
Ἰβύκου	person
Ἰδαίους	ethnic, person
Ἰδαῖον	ethnic, person
Ἰδαῖος	ethnic, person
Ἰδομενέα	person
Ἰδομενεὺς	person
Ἰηλυσὸν	person
Ἰθάκην	person, place
Ἰθάκης	person, place
Ἰθάκῃ	person, place
Ἰθακησίου	person
Ἰκάριον	person
Ἰκάριος	person
Ἰκαρίαν	person
Ἰκαρίου	person
Ἰκαρίῳ	person
Ἰλιάδα	person
Ἰλιάδι	person
Ἰλιάδος	person
Ἰλιακὸς	person
Ἰλιακῇ	person
Ἰνάχῳ	person
Ἰνδική	ethnic, place
Ἰνδοί	person
Ἰνδοὺς	person
Ἰνδοῖς	person
Ἰνδοῦ	person
Ἰνδὸν	person
Ἰνδὸς	person
Ἰνδῶν	person
Ἰνὼ	person
Ἰξίονί	person
Ἰξίων	person
Ἰογόρθαν	person
Ἰοκάστη	person
Ἰοκάστην	person
Ἰολάου	person
Ἰουλιανόν	person
Ἰούλιος	person
Ἰοῖ	person
Ἰοῦς	person
Ἰπνῷ	place
Ἰσίδωρος	person
Ἰσθμιάδος	person
Ἰσοκράτη	person
Ἰσοκράτης	person
Ἰσοκράτους	person
Ἰσχομάχου	person
Ἰσχόμαχον	person
Ἰσχόμαχος	person
Ἰταλίαν	person, place
Ἰταλίας	person, place
Ἰταλίης	person, place
Ἰταλίᾳ	person, place
Ἰταλίῃ	person, place
Ἰταλικῶν	ethnic, place
Ἰφίκλου	person
Ἰφίκλῳ	person
Ἰφίτου	person
Ἰφιγενείᾳ	person
Ἰφικράτει	person
Ἰφικράτης	person
Ἰφικράτους	person
Ἰωλκός	place
Ἰωνία	person, place
Ἰωνική	person
Ἰωνικήν	person
Ἰωνικαί	person
Ἰωνικόν	person
Ἰωνικὸς	person
Ἰωνικῶν	person
Ἰόβα	person
Ἰόβαν	person
Ἰόβας	person
Ἰόλεώς	person
Ἰόλης	person
Ἰόνιον	person
Ἰώνων	person
Ἰᾶπυξ	ethnic, person, place
Ἱέρακά	person
Ἱέρων	person, place
Ἱέρωνα	person
Ἱέρωνι	person
Ἱέρωνος	person
Ἱατροκλῆς	person
Ἱεροκλέος	person
Ἱερωνύμου	person
Ἱερώνυμον	person
Ἱερώνυμος	person
Ἱκέσιος	person
Ἱκεσίου	person
Ἱππάρχου	person
Ἱππάρχῳ	person
Ἱππίαν	person
Ἱππίας	person
Ἱππίου	person
Ἱππίᾳ	person
Ἱππαγόρας	person
Ἱππαρέτη	person
Ἱππαρῖνον	person
Ἱππαρῖνος	person
Ἱππεῖ	person
Ἱπποδάμειάν	person
Ἱπποθάλης	person
Ἱπποκλῆς	person
Ἱπποκράτεος	person
Ἱπποκράτης	person
Ἱπποκράτους	person
Ἱππολόχου	person
Ἱππολύτην	person
Ἱππολύτῳ	person
Ἱππονίκου	person
Ἱπποστράτου	person
Ἱππόδαμος	person
Ἱππόλοχον	person
Ἱππόλοχος	person
Ἱππόμαχον	person
Ἱππόνικε	person
Ἱππόνικον	person
Ἱππόνικος	person
Ἱππώνακτα	person
Ἱππώνακτι	person
Ἱππώνακτος	person
Ἱππώνιον	place
Ἱππῶναξ	person
Ἲων	person
Ἴασον	person
Ἴβηρες	ethnic, place
Ἴβηρός	ethnic, place
Ἴβυκος	person
Ἴθακος	person
Ἴκαρος	place
Ἴλιον	place
Ἴννα	place
Ἴριδι	person, place
Ἴσθμιος	person
Ἴσσῃ	person
Ἴστρον	place
Ἴστρος	place
Ἴφικλον	person
Ἴφικλος	person
Ἴωνα	person
Ἴωνας	person
Ἴωνες	person
Ἴωνι	person
Ἴωνος	person
Ἴωσι	person
Ἴωσιν	person
Ἵμερον	person
Ἵππαρχον	person
Ἵππασος	person
Ἵππυς	person
Ἶρις	person, place
Ἶρος	person
Ὀδάτιν	person
Ὀδάτις	person
Ὀδυσεὺς	person
Ὀδυσσέα	person
Ὀδυσσέως	person
Ὀδυσσεὺς	person
Ὀδυσσεῖ	person
Ὀδυσσεῦσι	person
Ὀλυμπίαισι	person, place
Ὀλυμπίαν	person, place
Ὀλυμπίας	person, place
Ὀλυμπίασί	person, place
Ὀλυμπίασιν	person, place
Ὀλυμπίοις	ethnic, person
Ὀλυμπίου	ethnic, person
Ὀλυμπίχου	person
Ὀλυμπίων	ethnic, person
Ὀλυμπίῃ	person, place
Ὀλυμπίῳ	ethnic, person
Ὀλυμπιάδα	person, place
Ὀλυμπιάδι	person, place
Ὀλυμπιάδος	person, place
Ὀλυμπιείου	place
Ὀλυμπικὴν	person
Ὀλυμπικῷ	person
Ὀλυμπιοδώρῳ	person
Ὀλύμπια	ethnic, person
Ὀλύμπιον	ethnic, person
Ὀλύμπιος	ethnic, person
Ὀμφάλην	person
Ὀμφάλης	person, place
Ὀμφάλῃ	person
Ὀνόμαρχον	person
Ὀνόμαρχος	person
Ὀξυάρτου	person
Ὀξυθέμιδος	person
Ὀξύθεμιν	person
Ὀξύλου	person
Ὀπώρᾳ	person
Ὀρέστην	person
Ὀρέστῃ	person
Ὀρεσθεὺς	person
Ὀρθαγόρᾳ	person
Ὀροίτου	person
Ὀρτυγίαν	person, place
Ὀρτύγης	person
Ὀρφέα	person
Ὀρφέως	person
Ὀρφεὺς	person
Ὀρχομενὸν	place
Ὀσίριδος	person
Ὁμήρου	person
Ὁμήρῳ	person
Ὁμηρικήν	person
Ὁμηρικοὶ	person
Ὁμηρικὰ	person
Ὁμηρικὸν	person
Ὁμηρικὸς	person
Ὁμηρικῶν	person
Ὁμηρικῶς	person
Ὄλυμπον	place
Ὄξυλον	person
Ὄππιος	person
Ὅμηρον	person
Ὅμηρος	person
Ὑβρίου	person
Ὑπέρβολος	person
Ὑπέρου	person
Ὑπέροχος	person
Ὑπερίονος	person
Ὑπερείδην	person
Ὑπερείδης	person
Ὑπερείδῃ	person
Ὑστάσπης	person
Ὑστάσπῃ	person
Ὑψέως	person
Ὑψιπύλην	person
Ὑψιπύλης	person
Ὠκεανοῖο	person
Ὠκεανοῦ	person
Ὠκεανὸν	person
Ὠκεανὸς	person
Ὠκυρόην	person
Ὠρίων	person
Ὠρίωνα	person
Ὠρίωνος	person
Ὠρεῖται	place
Ὠφελίων	person
Ὦχος	place
Ῥέας	place
Ῥίνθων	person
Ῥαδάμανθυν	person
Ῥαδάμανθυς	person
Ῥαδαμάνθυος	person
Ῥηγῖνος	ethnic, person
Ῥιανὸς	person
Ῥοδίων	ethnic, person
Ῥοδοφῶν	person
Ῥοδοφῶντα	person
Ῥοδῶπιν	person
Ῥουτίλιος	person
Ῥουτιλίῳ	person
Ῥουφῖνός	person
Ῥοῦφος	person
Ῥωμαῖος	ethnic, person
Ῥωμύλου	person
Ῥόδη	person, place
Ῥόδιον	ethnic, person
Ῥόδιος	ethnic, person, place
Ῥόδον	person, place
Ῥόδος	person, place
Ῥόδου	person, place
Ῥόδῳ	person, place
’Άνυτος	person
